Sequence	Result
IAVLYQS_1.pdb	CLEAVED
RCACYQS_2.pdb	CLEAVED
VLGWYQS_2.pdb	CLEAVED
MVAGFQS_1.pdb	CLEAVED
LRGYWQS_3.pdb	CLEAVED
VWPRGQS_4.pdb	CLEAVED
SYGCVQS_0.pdb	CLEAVED
LLWSRQS_4.pdb	CLEAVED
DMGYCQS_2.pdb	CLEAVED
WPSRQQS_2.pdb	CLEAVED
PTTQFQS_3.pdb	CLEAVED
AAHLFQS_3.pdb	CLEAVED
SVGHFQS_2.pdb	CLEAVED
IHDALQS_3.pdb	CLEAVED
IHVAYQS_0.pdb	CLEAVED
CAVKFQS_4.pdb	CLEAVED
FLCHIQS_1.pdb	CLEAVED
GLVRYQS_0.pdb	CLEAVED
MVYRRQS_1.pdb	CLEAVED
DHPTFQS_2.pdb	CLEAVED
SWVNVQS_0.pdb	CLEAVED
YRATYQS_3.pdb	CLEAVED
STPHFQS_0.pdb	CLEAVED
WQGIAQS_1.pdb	CLEAVED
RPMNVQS_4.pdb	CLEAVED
DMARYQS_4.pdb	CLEAVED
VWQGFQS_2.pdb	CLEAVED
SEASFQS_4.pdb	CLEAVED
ATAGFQS_3.pdb	CLEAVED
PTVWVQS_3.pdb	CLEAVED
CRATYQS_1.pdb	CLEAVED
TSVTFQS_1.pdb	CLEAVED
RVPSYQS_3.pdb	CLEAVED
CAANFQS_0.pdb	CLEAVED
IEVLFQS_2.pdb	CLEAVED
WLTRRQS_0.pdb	CLEAVED
QWAVVQS_0.pdb	CLEAVED
SLLRRQS_4.pdb	CLEAVED
WRHPFQS_0.pdb	CLEAVED
LLSRRQS_2.pdb	CLEAVED
NHYCVQS_1.pdb	CLEAVED
DVVWYQS_4.pdb	CLEAVED
CHASFQS_2.pdb	CLEAVED
PTPYYQS_4.pdb	CLEAVED
ALGWFQS_1.pdb	CLEAVED
HLADFQS_1.pdb	CLEAVED
CFASYQS_4.pdb	CLEAVED
TGARYQS_3.pdb	CLEAVED
RRYVYQS_3.pdb	CLEAVED
GWAFLQS_0.pdb	CLEAVED
VWADFQS_0.pdb	CLEAVED
LDTYFQS_4.pdb	CLEAVED
DIGFYQS_3.pdb	CLEAVED
TYCLNQS_3.pdb	CLEAVED
LTAGYQS_2.pdb	CLEAVED
SLPYFQS_4.pdb	CLEAVED
LYGSYQS_1.pdb	CLEAVED
KRIPWQS_1.pdb	CLEAVED
VSRRRQS_0.pdb	CLEAVED
CLLILQS_2.pdb	CLEAVED
YMRRGQS_1.pdb	CLEAVED
SAVRFQS_3.pdb	CLEAVED
MVADWQS_3.pdb	CLEAVED
PEATMQS_1.pdb	CLEAVED
PPCWFQS_4.pdb	CLEAVED
PLVAYQS_4.pdb	CLEAVED
HSATFQS_0.pdb	CLEAVED
EVEFQQS_0.pdb	CLEAVED
WQGMKQS_0.pdb	CLEAVED
THVVFQS_4.pdb	CLEAVED
SYVGYQS_3.pdb	CLEAVED
SGATFQS_4.pdb	CLEAVED
WRVFFQS_1.pdb	CLEAVED
WGVRYQS_3.pdb	CLEAVED
TDVLYQS_3.pdb	CLEAVED
LGAIWQS_3.pdb	CLEAVED
LDVLFQS_1.pdb	CLEAVED
NRIEFQS_3.pdb	CLEAVED
AGAVWQS_1.pdb	CLEAVED
AMPSFQS_2.pdb	CLEAVED
DYAVLQS_0.pdb	CLEAVED
HRVVFQS_1.pdb	CLEAVED
NGVSFQS_4.pdb	CLEAVED
TTGRFQS_2.pdb	CLEAVED
CPVVFQS_3.pdb	CLEAVED
HSAIFQS_4.pdb	CLEAVED
FSATFQS_4.pdb	CLEAVED
NKVSFQS_0.pdb	CLEAVED
RRIQFQS_2.pdb	CLEAVED
VYADVQS_1.pdb	CLEAVED
HGPVFQS_1.pdb	CLEAVED
HLVVRQS_0.pdb	CLEAVED
NFAVHQS_3.pdb	CLEAVED
SRAWFQS_4.pdb	CLEAVED
QYVAYQS_2.pdb	CLEAVED
IEVGYQS_2.pdb	CLEAVED
VYAWVQS_3.pdb	CLEAVED
LWVQYQS_2.pdb	CLEAVED
SEVLFQS_2.pdb	CLEAVED
YIVHFQS_3.pdb	CLEAVED
VPCWYQS_0.pdb	CLEAVED
KRVHFQS_2.pdb	CLEAVED
WQGKHQS_3.pdb	CLEAVED
YQGRGQS_3.pdb	CLEAVED
LHAYLQS_2.pdb	CLEAVED
CLPIFQS_0.pdb	CLEAVED
RDGVFQS_1.pdb	CLEAVED
PGACFQS_0.pdb	CLEAVED
LEILFQS_0.pdb	CLEAVED
LEVLFQS_2.pdb	CLEAVED
WLSRKQS_4.pdb	CLEAVED
HKCYYQS_3.pdb	CLEAVED
VWAFLQS_4.pdb	CLEAVED
LEPDFQS_3.pdb	CLEAVED
QSPEYQS_1.pdb	CLEAVED
LDVWFQS_3.pdb	CLEAVED
LRVVFQS_4.pdb	CLEAVED
HFVRYQS_4.pdb	CLEAVED
LEALFQS_2.pdb	CLEAVED
LHARDQS_4.pdb	CLEAVED
PYVYLQS_3.pdb	CLEAVED
DPPIFQS_2.pdb	CLEAVED
KRVQFQS_2.pdb	CLEAVED
FACFYQS_1.pdb	CLEAVED
CQTVFQS_4.pdb	CLEAVED
DLNWFQS_2.pdb	CLEAVED
YHIEYQS_0.pdb	CLEAVED
LEVLYQS_2.pdb	CLEAVED
LVPHFQS_2.pdb	CLEAVED
DHVRFQS_2.pdb	CLEAVED
LEVVFQS_3.pdb	CLEAVED
LLVLFQS_1.pdb	CLEAVED
LITTYQS_3.pdb	CLEAVED
HEGIYQS_4.pdb	CLEAVED
LGVLFQS_1.pdb	CLEAVED
DLPTWQS_4.pdb	CLEAVED
FKRSWQS_4.pdb	CLEAVED
MTCFFQS_2.pdb	CLEAVED
FLYNRQS_4.pdb	CLEAVED
ANPSYQS_2.pdb	CLEAVED
MDVFYQS_2.pdb	CLEAVED
GCALFQS_4.pdb	CLEAVED
WYAHFQS_0.pdb	CLEAVED
LEVFFQS_2.pdb	CLEAVED
LEGLFQS_2.pdb	CLEAVED
HVVFQQS_2.pdb	CLEAVED
PCYQSQS_0.pdb	CLEAVED
LKVLFQS_4.pdb	CLEAVED
NQPIYQS_0.pdb	CLEAVED
KIARYQS_4.pdb	CLEAVED
PKVAYQS_0.pdb	CLEAVED
TVNVFQS_0.pdb	CLEAVED
LEVPFQS_2.pdb	CLEAVED
KRAWLQS_3.pdb	CLEAVED
PKVLYQS_4.pdb	CLEAVED
LAGVYQS_2.pdb	CLEAVED
WRVSYQS_4.pdb	CLEAVED
ITCWFQS_2.pdb	CLEAVED
SLVTYQS_0.pdb	CLEAVED
YYASYQS_2.pdb	CLEAVED
TWARYQS_3.pdb	CLEAVED
LVVLFQS_4.pdb	CLEAVED
KPTFLQS_1.pdb	CLEAVED
ITPTFQS_2.pdb	CLEAVED
LVNVWQS_0.pdb	CLEAVED
GWPTYQS_2.pdb	CLEAVED
LEVLIQS_0.pdb	CLEAVED
DTVLYQS_2.pdb	CLEAVED
NLAHFQS_3.pdb	CLEAVED
YKASFQS_2.pdb	CLEAVED
VSVKFQS_2.pdb	CLEAVED
HCETNQS_2.pdb	UNCLEAVED
LARVCQS_4.pdb	UNCLEAVED
SRQGRQS_0.pdb	UNCLEAVED
VWVVGQS_3.pdb	UNCLEAVED
PCMWVQS_1.pdb	UNCLEAVED
EPFCCQS_0.pdb	UNCLEAVED
CWDTQQS_3.pdb	UNCLEAVED
LCPIRQS_3.pdb	UNCLEAVED
EACPAQS_0.pdb	UNCLEAVED
ETRGRQS_3.pdb	UNCLEAVED
FMSACQS_3.pdb	UNCLEAVED
FLAVGQS_0.pdb	UNCLEAVED
WVRAWQS_0.pdb	UNCLEAVED
GLDWGQS_0.pdb	UNCLEAVED
SKGPRQS_0.pdb	UNCLEAVED
AYWLYQS_4.pdb	UNCLEAVED
MGGVEQS_3.pdb	UNCLEAVED
RGEEGQS_3.pdb	UNCLEAVED
KSAQDQS_1.pdb	UNCLEAVED
GDGMAQS_4.pdb	UNCLEAVED
WEQNRQS_4.pdb	UNCLEAVED
WDSGWQS_3.pdb	UNCLEAVED
WRGGGQS_3.pdb	UNCLEAVED
HLYGWQS_3.pdb	UNCLEAVED
SREHGQS_3.pdb	UNCLEAVED
TISRPQS_3.pdb	UNCLEAVED
FPRNSQS_4.pdb	UNCLEAVED
TWFYIQS_4.pdb	UNCLEAVED
RHWGGQS_4.pdb	UNCLEAVED
IGYGMQS_4.pdb	UNCLEAVED
FMGIGQS_3.pdb	UNCLEAVED
RVSVNQS_1.pdb	UNCLEAVED
HTGTSQS_2.pdb	UNCLEAVED
IQNLIQS_1.pdb	UNCLEAVED
LLTGCQS_0.pdb	UNCLEAVED
SGFGFQS_4.pdb	UNCLEAVED
CKSLAQS_2.pdb	UNCLEAVED
TGGVEQS_4.pdb	UNCLEAVED
DGAPGQS_4.pdb	UNCLEAVED
SNPGVQS_3.pdb	UNCLEAVED
RITKSQS_2.pdb	UNCLEAVED
IVTVSQS_0.pdb	UNCLEAVED
EYQYGQS_1.pdb	UNCLEAVED
CLRSMQS_2.pdb	UNCLEAVED
FFTAKQS_2.pdb	UNCLEAVED
THMFTQS_4.pdb	UNCLEAVED
DLGVGQS_3.pdb	UNCLEAVED
LESISQS_3.pdb	UNCLEAVED
DDLGGQS_2.pdb	UNCLEAVED
NFMREQS_3.pdb	UNCLEAVED
WLSLSQS_4.pdb	UNCLEAVED
YALAGQS_1.pdb	UNCLEAVED
HREARQS_0.pdb	UNCLEAVED
RAGGGQS_0.pdb	UNCLEAVED
YTDTNQS_0.pdb	UNCLEAVED
AASYSQS_0.pdb	UNCLEAVED
AGGQVQS_1.pdb	UNCLEAVED
GGLDMQS_3.pdb	UNCLEAVED
FAFQRQS_0.pdb	UNCLEAVED
YIWVAQS_2.pdb	UNCLEAVED
AVWKYQS_3.pdb	UNCLEAVED
CTGPYQS_0.pdb	UNCLEAVED
PYTADQS_0.pdb	UNCLEAVED
DSGMAQS_4.pdb	UNCLEAVED
DSEGPQS_2.pdb	UNCLEAVED
FPWSNQS_0.pdb	UNCLEAVED
VSGTQQS_3.pdb	UNCLEAVED
TKSLNQS_1.pdb	UNCLEAVED
RALSRQS_3.pdb	UNCLEAVED
LMENIQS_1.pdb	UNCLEAVED
AMESLQS_1.pdb	UNCLEAVED
VRTDSQS_1.pdb	UNCLEAVED
YPDSKQS_1.pdb	UNCLEAVED
TMALSQS_0.pdb	UNCLEAVED
TMTFDQS_0.pdb	UNCLEAVED
VEFLRQS_2.pdb	UNCLEAVED
GSNNAQS_2.pdb	UNCLEAVED
WAFHPQS_4.pdb	UNCLEAVED
GFMLAQS_3.pdb	UNCLEAVED
ISMSMQS_0.pdb	UNCLEAVED
AWNTNQS_2.pdb	UNCLEAVED
PVLQPQS_4.pdb	UNCLEAVED
QCSLSQS_4.pdb	UNCLEAVED
RGEVDQS_0.pdb	UNCLEAVED
TGSAGQS_0.pdb	UNCLEAVED
LLHTNQS_4.pdb	UNCLEAVED
CMWPHQS_4.pdb	UNCLEAVED
MGRHLQS_4.pdb	UNCLEAVED
RLEVSQS_3.pdb	UNCLEAVED
FTWGGQS_1.pdb	UNCLEAVED
QIHRHQS_0.pdb	UNCLEAVED
RTWNSQS_2.pdb	UNCLEAVED
LWQWEQS_0.pdb	UNCLEAVED
VAGDGQS_4.pdb	UNCLEAVED
TMWEAQS_3.pdb	UNCLEAVED
AGRFGQS_1.pdb	UNCLEAVED
EVLSPQS_2.pdb	UNCLEAVED
SSGGQQS_2.pdb	UNCLEAVED
QGIVSQS_1.pdb	UNCLEAVED
RFRPSQS_2.pdb	UNCLEAVED
PFRFTQS_2.pdb	UNCLEAVED
GVSCLQS_1.pdb	UNCLEAVED
AWGSSQS_0.pdb	UNCLEAVED
DSKPYQS_3.pdb	UNCLEAVED
CCRGEQS_2.pdb	UNCLEAVED
RVAGAQS_0.pdb	UNCLEAVED
HAYIGQS_3.pdb	UNCLEAVED
GSMGVQS_3.pdb	UNCLEAVED
GTEDWQS_1.pdb	UNCLEAVED
QHYDSQS_4.pdb	UNCLEAVED
RWSPSQS_1.pdb	UNCLEAVED
RSSFLQS_4.pdb	UNCLEAVED
QVGGRQS_4.pdb	UNCLEAVED
VPSAQQS_1.pdb	UNCLEAVED
RCGGGQS_2.pdb	UNCLEAVED
SVGRCQS_2.pdb	UNCLEAVED
TWYRVQS_0.pdb	UNCLEAVED
FYKGGQS_3.pdb	UNCLEAVED
KLAAGQS_0.pdb	UNCLEAVED
CSRGMQS_1.pdb	UNCLEAVED
KVTNGQS_2.pdb	UNCLEAVED
GNARGQS_0.pdb	UNCLEAVED
VFSHHQS_2.pdb	UNCLEAVED
VGGGRQS_2.pdb	UNCLEAVED
LSTAGQS_3.pdb	UNCLEAVED
FTSSPQS_1.pdb	UNCLEAVED
MRSYGQS_0.pdb	UNCLEAVED
SSTPVQS_1.pdb	UNCLEAVED
LSGARQS_4.pdb	UNCLEAVED
WAPSSQS_2.pdb	UNCLEAVED
YWNMVQS_3.pdb	UNCLEAVED
GTLMSQS_4.pdb	UNCLEAVED
SMSVSQS_3.pdb	UNCLEAVED
GPHPSQS_2.pdb	UNCLEAVED
ALRDMQS_2.pdb	UNCLEAVED
LPLVGQS_2.pdb	UNCLEAVED
LLGHGQS_4.pdb	UNCLEAVED
SCLYKQS_4.pdb	UNCLEAVED
AANLRQS_0.pdb	UNCLEAVED
SLFRVQS_2.pdb	UNCLEAVED
WWWRAQS_2.pdb	UNCLEAVED
VDFTVQS_0.pdb	UNCLEAVED
VVWHSQS_1.pdb	UNCLEAVED
LVSYSQS_4.pdb	UNCLEAVED
RNSMLQS_3.pdb	UNCLEAVED
RPTEGQS_2.pdb	UNCLEAVED
HSMNTQS_2.pdb	UNCLEAVED
FRTTRQS_4.pdb	UNCLEAVED
LRSVSQS_4.pdb	UNCLEAVED
WVSEGQS_3.pdb	UNCLEAVED
RHSWGQS_4.pdb	UNCLEAVED
TLSLIQS_3.pdb	UNCLEAVED
CSRSLQS_0.pdb	UNCLEAVED
SCLPSQS_3.pdb	UNCLEAVED
VGSGKQS_2.pdb	UNCLEAVED
TWSVRQS_0.pdb	UNCLEAVED
RTSPTQS_3.pdb	UNCLEAVED
RALPQQS_3.pdb	UNCLEAVED
PMYTDQS_1.pdb	UNCLEAVED
LYHLLQS_3.pdb	UNCLEAVED
GGPLRQS_0.pdb	UNCLEAVED
PYSVTQS_2.pdb	UNCLEAVED
FGPPYQS_0.pdb	UNCLEAVED
CRDGSQS_1.pdb	UNCLEAVED
CPLSGQS_1.pdb	UNCLEAVED
FDLHLQS_3.pdb	UNCLEAVED
CMGDSQS_4.pdb	UNCLEAVED
CAGGVQS_4.pdb	UNCLEAVED
WMSGTQS_2.pdb	UNCLEAVED
VRNGLQS_4.pdb	UNCLEAVED
GKFGYQS_2.pdb	UNCLEAVED
RTLYIQS_2.pdb	UNCLEAVED
WDRSVQS_3.pdb	UNCLEAVED
SAMRSQS_3.pdb	UNCLEAVED
IWEAYQS_2.pdb	UNCLEAVED
FRHLTQS_2.pdb	UNCLEAVED
REEGAQS_1.pdb	UNCLEAVED
LMGVPQS_0.pdb	UNCLEAVED
LRWWSQS_4.pdb	UNCLEAVED
TGGRVQS_4.pdb	UNCLEAVED
VGLWVQS_4.pdb	UNCLEAVED
CCRFPQS_0.pdb	UNCLEAVED
LHSDSQS_0.pdb	UNCLEAVED
LITWRQS_4.pdb	UNCLEAVED
FCTAMQS_4.pdb	UNCLEAVED
REKAQQS_4.pdb	UNCLEAVED
YTDTMQS_1.pdb	UNCLEAVED
RNGSDQS_0.pdb	UNCLEAVED
NLGHGQS_3.pdb	UNCLEAVED
GWPVSQS_3.pdb	UNCLEAVED
STWMLQS_4.pdb	UNCLEAVED
DTGGAQS_2.pdb	UNCLEAVED
MGWRVQS_2.pdb	UNCLEAVED
GLLAGQS_4.pdb	UNCLEAVED
TMWPGQS_1.pdb	UNCLEAVED
SKQGGQS_0.pdb	UNCLEAVED
RNSGLQS_1.pdb	UNCLEAVED
LHGIGQS_4.pdb	UNCLEAVED
HHNSSQS_3.pdb	UNCLEAVED
FWEMRQS_2.pdb	UNCLEAVED
CGGLTQS_2.pdb	UNCLEAVED
SHWLCQS_2.pdb	UNCLEAVED
AGRSIQS_4.pdb	UNCLEAVED
GRGGAQS_4.pdb	UNCLEAVED
TLGTCQS_2.pdb	UNCLEAVED
NGWAYQS_2.pdb	UNCLEAVED
TAFRDQS_3.pdb	UNCLEAVED
STDLLQS_1.pdb	UNCLEAVED
KLAGGQS_0.pdb	UNCLEAVED
YPLRAQS_1.pdb	UNCLEAVED
VLEGTQS_4.pdb	UNCLEAVED
CNGLEQS_4.pdb	UNCLEAVED
SGWGRQS_4.pdb	UNCLEAVED
VRAGRQS_3.pdb	UNCLEAVED
NCRDGQS_3.pdb	UNCLEAVED
TGALDQS_3.pdb	UNCLEAVED
PCRQYQS_0.pdb	UNCLEAVED
TLLFAQS_3.pdb	UNCLEAVED
NGRERQS_1.pdb	UNCLEAVED
RMGTSQS_2.pdb	UNCLEAVED
LGWNVQS_2.pdb	UNCLEAVED
TSGRGQS_1.pdb	UNCLEAVED
CSRTQQS_2.pdb	UNCLEAVED
SHGMVQS_3.pdb	UNCLEAVED
SRGGHQS_1.pdb	UNCLEAVED
RSPLAQS_2.pdb	UNCLEAVED
KVIPGQS_3.pdb	UNCLEAVED
RIGGMQS_0.pdb	UNCLEAVED
FGPSAQS_2.pdb	UNCLEAVED
IGWWAQS_4.pdb	UNCLEAVED
CHGRGQS_2.pdb	UNCLEAVED
LVPGRQS_0.pdb	UNCLEAVED
LWRWVQS_2.pdb	UNCLEAVED
PCERIQS_1.pdb	UNCLEAVED
LSGGGQS_2.pdb	UNCLEAVED
TASLGQS_4.pdb	UNCLEAVED
RSSVHQS_1.pdb	UNCLEAVED
PWRADQS_2.pdb	UNCLEAVED
SGSQSQS_3.pdb	UNCLEAVED
VAGGDQS_4.pdb	UNCLEAVED
NRYFHQS_4.pdb	UNCLEAVED
HSTSSQS_3.pdb	UNCLEAVED
FHMFLQS_4.pdb	UNCLEAVED
EWMRVQS_4.pdb	UNCLEAVED
CVSPMQS_1.pdb	UNCLEAVED
LRLAHQS_1.pdb	UNCLEAVED
CRDISQS_3.pdb	UNCLEAVED
ALYFSQS_2.pdb	UNCLEAVED
WRSKNQS_2.pdb	UNCLEAVED
LWGSSQS_2.pdb	UNCLEAVED
DLGGRQS_2.pdb	UNCLEAVED
LLWLDQS_0.pdb	UNCLEAVED
YHSFHQS_2.pdb	UNCLEAVED
CVGRCQS_1.pdb	UNCLEAVED
CFYLVQS_2.pdb	UNCLEAVED
NLSRDQS_4.pdb	UNCLEAVED
PGPVGQS_4.pdb	UNCLEAVED
IVLTDQS_1.pdb	UNCLEAVED
VNDYVQS_2.pdb	UNCLEAVED
AWSGWQS_0.pdb	UNCLEAVED
SAVTDQS_3.pdb	UNCLEAVED
ECGHSQS_1.pdb	UNCLEAVED
NCNGMQS_2.pdb	UNCLEAVED
CASGNQS_3.pdb	UNCLEAVED
LSSGLQS_3.pdb	UNCLEAVED
LFWWDQS_3.pdb	UNCLEAVED
PLDRPQS_0.pdb	UNCLEAVED
SLWCSQS_4.pdb	UNCLEAVED
VWQLWQS_3.pdb	UNCLEAVED
RSELGQS_2.pdb	UNCLEAVED
FYRTNQS_1.pdb	UNCLEAVED
YLRFDQS_1.pdb	UNCLEAVED
CEEPMQS_2.pdb	UNCLEAVED
GGGKQQS_1.pdb	UNCLEAVED
YREEGQS_1.pdb	UNCLEAVED
YVPGPQS_0.pdb	UNCLEAVED
LLYYLQS_0.pdb	UNCLEAVED
LHMATQS_3.pdb	UNCLEAVED
FSRMSQS_2.pdb	UNCLEAVED
RPCAPQS_2.pdb	UNCLEAVED
MSGYTQS_4.pdb	UNCLEAVED
IPSFTQS_0.pdb	UNCLEAVED
RPLSPQS_3.pdb	UNCLEAVED
SITRAQS_3.pdb	UNCLEAVED
HLMGSQS_2.pdb	UNCLEAVED
LRGGPQS_1.pdb	UNCLEAVED
HNVTGQS_0.pdb	UNCLEAVED
RMLSPQS_0.pdb	UNCLEAVED
YSGEGQS_0.pdb	UNCLEAVED
LSGKDQS_0.pdb	UNCLEAVED
RLGLGQS_2.pdb	UNCLEAVED
LGQHQQS_3.pdb	UNCLEAVED
VLMICQS_2.pdb	UNCLEAVED
SCGPWQS_4.pdb	UNCLEAVED
WPLFTQS_1.pdb	UNCLEAVED
DHRGRQS_2.pdb	UNCLEAVED
RNMCTQS_2.pdb	UNCLEAVED
YLAGGQS_0.pdb	UNCLEAVED
TSYLEQS_3.pdb	UNCLEAVED
MFTGTQS_0.pdb	UNCLEAVED
MWGGGQS_4.pdb	UNCLEAVED
TCFSTQS_4.pdb	UNCLEAVED
LALGSQS_2.pdb	UNCLEAVED
QGTWTQS_1.pdb	UNCLEAVED
FLTNCQS_3.pdb	UNCLEAVED
GGMRAQS_2.pdb	UNCLEAVED
LRNLVQS_4.pdb	UNCLEAVED
FEFCSQS_1.pdb	UNCLEAVED
MSRGLQS_3.pdb	UNCLEAVED
LTTIAQS_4.pdb	UNCLEAVED
EHFSAQS_2.pdb	UNCLEAVED
ERRIYQS_1.pdb	UNCLEAVED
TIKICQS_0.pdb	UNCLEAVED
GQHVRQS_4.pdb	UNCLEAVED
SVWLEQS_3.pdb	UNCLEAVED
SVLYIQS_4.pdb	UNCLEAVED
HFGTSQS_0.pdb	UNCLEAVED
GTGLGQS_2.pdb	UNCLEAVED
DVSMAQS_2.pdb	UNCLEAVED
RYPDSQS_2.pdb	UNCLEAVED
LLYGHQS_0.pdb	UNCLEAVED
QARGSQS_4.pdb	UNCLEAVED
GYSLIQS_0.pdb	UNCLEAVED
RAKSSQS_2.pdb	UNCLEAVED
LGRGPQS_4.pdb	UNCLEAVED
VSPKRQS_0.pdb	UNCLEAVED
STGLRQS_0.pdb	UNCLEAVED
WWLGSQS_0.pdb	UNCLEAVED
WMTLRQS_3.pdb	UNCLEAVED
HSNLIQS_3.pdb	UNCLEAVED
WSILSQS_2.pdb	UNCLEAVED
AGKYCQS_1.pdb	UNCLEAVED
LWRDGQS_3.pdb	UNCLEAVED
RRGAAQS_3.pdb	UNCLEAVED
SSPIGQS_0.pdb	UNCLEAVED
WCHARQS_1.pdb	UNCLEAVED
FCELVQS_0.pdb	UNCLEAVED
YANQAQS_0.pdb	UNCLEAVED
CLLVGQS_0.pdb	UNCLEAVED
LCNDRQS_1.pdb	UNCLEAVED
WWSRSQS_2.pdb	UNCLEAVED
GRWWRQS_1.pdb	UNCLEAVED
LVWWRQS_4.pdb	UNCLEAVED
MLSNTQS_1.pdb	UNCLEAVED
SWDKIQS_2.pdb	UNCLEAVED
YREVKQS_1.pdb	UNCLEAVED
SDLIGQS_1.pdb	UNCLEAVED
CRAGAQS_4.pdb	UNCLEAVED
DPGSQQS_2.pdb	UNCLEAVED
GSCVGQS_2.pdb	UNCLEAVED
LSTSCQS_1.pdb	UNCLEAVED
CGEAVQS_2.pdb	UNCLEAVED
GGWMLQS_3.pdb	UNCLEAVED
AWWAPQS_2.pdb	UNCLEAVED
RLEGGQS_2.pdb	UNCLEAVED
YMEWSQS_2.pdb	UNCLEAVED
NGQTLQS_3.pdb	UNCLEAVED
QWERWQS_0.pdb	UNCLEAVED
RTLPIQS_2.pdb	UNCLEAVED
IPNMSQS_3.pdb	UNCLEAVED
PFSMAQS_0.pdb	UNCLEAVED
CRTSNQS_4.pdb	UNCLEAVED
RSAASQS_0.pdb	UNCLEAVED
SVVASQS_4.pdb	UNCLEAVED
LARYSQS_0.pdb	UNCLEAVED
NGWGDQS_1.pdb	UNCLEAVED
GNDSPQS_3.pdb	UNCLEAVED
FASDRQS_2.pdb	UNCLEAVED
QWRVVQS_0.pdb	UNCLEAVED
GPAAGQS_0.pdb	UNCLEAVED
LFHVSQS_0.pdb	UNCLEAVED
GFLLDQS_0.pdb	UNCLEAVED
LAGGMQS_1.pdb	UNCLEAVED
SRNWGQS_1.pdb	UNCLEAVED
RDTAWQS_0.pdb	UNCLEAVED
YDLCCQS_3.pdb	UNCLEAVED
FRVGNQS_3.pdb	UNCLEAVED
QTSHEQS_2.pdb	UNCLEAVED
QYCGSQS_3.pdb	UNCLEAVED
SIWPDQS_4.pdb	UNCLEAVED
PLRYIQS_4.pdb	UNCLEAVED
TGWVPQS_1.pdb	UNCLEAVED
RAGLCQS_1.pdb	UNCLEAVED
QPKQVQS_0.pdb	UNCLEAVED
YVDGHQS_1.pdb	UNCLEAVED
LGRANQS_2.pdb	UNCLEAVED
SVNMCQS_1.pdb	UNCLEAVED
YWDRMQS_0.pdb	UNCLEAVED
LVSSIQS_2.pdb	UNCLEAVED
VVSASQS_3.pdb	UNCLEAVED
CYKDVQS_0.pdb	UNCLEAVED
WGRARQS_2.pdb	UNCLEAVED
IRFASQS_1.pdb	UNCLEAVED
YHEAYQS_4.pdb	UNCLEAVED
SSLYAQS_1.pdb	UNCLEAVED
PGNTGQS_3.pdb	UNCLEAVED
RSHGVQS_4.pdb	UNCLEAVED
PMSSMQS_0.pdb	UNCLEAVED
LDPASQS_1.pdb	UNCLEAVED
RTSEEQS_1.pdb	UNCLEAVED
LHKSPQS_0.pdb	UNCLEAVED
YCLLPQS_1.pdb	UNCLEAVED
YGRTGQS_0.pdb	UNCLEAVED
SPWRLQS_1.pdb	UNCLEAVED
DLCCIQS_4.pdb	UNCLEAVED
RRWDKQS_4.pdb	UNCLEAVED
VGVLSQS_0.pdb	UNCLEAVED
CWLEAQS_3.pdb	UNCLEAVED
SQSSDQS_2.pdb	UNCLEAVED
TMGNDQS_1.pdb	UNCLEAVED
GDWEPQS_4.pdb	UNCLEAVED
RNRMPQS_0.pdb	UNCLEAVED
ASSNIQS_0.pdb	UNCLEAVED
GIKACQS_2.pdb	UNCLEAVED
SALGGQS_3.pdb	UNCLEAVED
SRGLSQS_4.pdb	UNCLEAVED
SWHSVQS_1.pdb	UNCLEAVED
HYAGSQS_3.pdb	UNCLEAVED
SAMSRQS_4.pdb	UNCLEAVED
GRYAVQS_4.pdb	UNCLEAVED
FTGPSQS_4.pdb	UNCLEAVED
QHRGFQS_2.pdb	UNCLEAVED
HFSRTQS_0.pdb	UNCLEAVED
RANTNQS_4.pdb	UNCLEAVED
CLSPIQS_2.pdb	UNCLEAVED
GVLWTQS_2.pdb	UNCLEAVED
PSWFMQS_3.pdb	UNCLEAVED
CVGLGQS_4.pdb	UNCLEAVED
PNVVDQS_0.pdb	UNCLEAVED
VCRMGQS_0.pdb	UNCLEAVED
SSLLSQS_2.pdb	UNCLEAVED
WCHGLQS_0.pdb	UNCLEAVED
YPGAGQS_0.pdb	UNCLEAVED
QRYYIQS_2.pdb	UNCLEAVED
YGAPGQS_3.pdb	UNCLEAVED
SGLGGQS_4.pdb	UNCLEAVED
AWDSDQS_2.pdb	UNCLEAVED
RGGHSQS_3.pdb	UNCLEAVED
RTGDSQS_0.pdb	UNCLEAVED
GLTRQQS_1.pdb	UNCLEAVED
RETGGQS_3.pdb	UNCLEAVED
TVSESQS_1.pdb	UNCLEAVED
FFSLCQS_1.pdb	UNCLEAVED
FTKFAQS_0.pdb	UNCLEAVED
WLEGWQS_0.pdb	UNCLEAVED
SAGIDQS_0.pdb	UNCLEAVED
YVDCPQS_2.pdb	UNCLEAVED
WAGTGQS_0.pdb	UNCLEAVED
FPQLAQS_4.pdb	UNCLEAVED
YQVPCQS_4.pdb	UNCLEAVED
VLTWGQS_1.pdb	UNCLEAVED
QYGGGQS_4.pdb	UNCLEAVED
PETSAQS_2.pdb	UNCLEAVED
KVMGPQS_4.pdb	UNCLEAVED
DNFTQQS_0.pdb	UNCLEAVED
DDHHNQS_0.pdb	UNCLEAVED
VCGSEQS_1.pdb	UNCLEAVED
DDSLRQS_3.pdb	UNCLEAVED
WWIGTQS_4.pdb	UNCLEAVED
CWYADQS_0.pdb	UNCLEAVED
PVNGGQS_3.pdb	UNCLEAVED
RYQLCQS_2.pdb	UNCLEAVED
SPFWLQS_2.pdb	UNCLEAVED
FSYCTQS_2.pdb	UNCLEAVED
IDRFCQS_2.pdb	UNCLEAVED
ARRVSQS_3.pdb	UNCLEAVED
RWVSGQS_0.pdb	UNCLEAVED
DQRELQS_0.pdb	UNCLEAVED
FYDQDQS_4.pdb	UNCLEAVED
SENTSQS_1.pdb	UNCLEAVED
RLTQDQS_0.pdb	UNCLEAVED
FWWVAQS_2.pdb	UNCLEAVED
LWYLLQS_1.pdb	UNCLEAVED
RSFLAQS_3.pdb	UNCLEAVED
LSIGNQS_1.pdb	UNCLEAVED
RWNKDQS_1.pdb	UNCLEAVED
ERGVSQS_3.pdb	UNCLEAVED
SRSGSQS_1.pdb	UNCLEAVED
SGQCQQS_0.pdb	UNCLEAVED
GLKSPQS_3.pdb	UNCLEAVED
LELLVQS_4.pdb	UNCLEAVED
WGDERQS_2.pdb	UNCLEAVED
LVSWCQS_1.pdb	UNCLEAVED
GHTLRQS_4.pdb	UNCLEAVED
MHGPGQS_0.pdb	UNCLEAVED
SWRPHQS_1.pdb	UNCLEAVED
GGCPSQS_1.pdb	UNCLEAVED
GRNPSQS_3.pdb	UNCLEAVED
QDRRKQS_3.pdb	UNCLEAVED
WGTDRQS_4.pdb	UNCLEAVED
MHRTEQS_4.pdb	UNCLEAVED
YDDSRQS_1.pdb	UNCLEAVED
LFHGRQS_3.pdb	UNCLEAVED
LYYKLQS_3.pdb	UNCLEAVED
PFMVTQS_0.pdb	UNCLEAVED
GGTLRQS_4.pdb	UNCLEAVED
KDFGCQS_1.pdb	UNCLEAVED
RQWRLQS_3.pdb	UNCLEAVED
TERIIQS_4.pdb	UNCLEAVED
LWDFHQS_2.pdb	UNCLEAVED
PLNHTQS_4.pdb	UNCLEAVED
DLEVGQS_2.pdb	UNCLEAVED
LNWVLQS_4.pdb	UNCLEAVED
MPMVSQS_1.pdb	UNCLEAVED
LWNPTQS_2.pdb	UNCLEAVED
ISMSSQS_3.pdb	UNCLEAVED
RDYLPQS_3.pdb	UNCLEAVED
VRFGDQS_1.pdb	UNCLEAVED
YGGRAQS_4.pdb	UNCLEAVED
STHGNQS_1.pdb	UNCLEAVED
MSGANQS_3.pdb	UNCLEAVED
EILAPQS_3.pdb	UNCLEAVED
LGRNTQS_4.pdb	UNCLEAVED
SLITSQS_4.pdb	UNCLEAVED
LGWAGQS_4.pdb	UNCLEAVED
EVGLGQS_1.pdb	UNCLEAVED
SPGERQS_4.pdb	UNCLEAVED
VSGHSQS_4.pdb	UNCLEAVED
RALARQS_0.pdb	UNCLEAVED
SVERLQS_1.pdb	UNCLEAVED
CVRALQS_1.pdb	UNCLEAVED
PLWLHQS_0.pdb	UNCLEAVED
VCCKGQS_4.pdb	UNCLEAVED
KGGWTQS_0.pdb	UNCLEAVED
MNNLEQS_1.pdb	UNCLEAVED
FVTVGQS_3.pdb	UNCLEAVED
WSAIDQS_2.pdb	UNCLEAVED
YREPNQS_1.pdb	UNCLEAVED
SADRIQS_3.pdb	UNCLEAVED
SMGLSQS_3.pdb	UNCLEAVED
GRRGGQS_2.pdb	UNCLEAVED
FTLTSQS_4.pdb	UNCLEAVED
ALSSKQS_4.pdb	UNCLEAVED
KLWGSQS_2.pdb	UNCLEAVED
VSSTTQS_3.pdb	UNCLEAVED
LVTVPQS_4.pdb	UNCLEAVED
DGGSVQS_0.pdb	UNCLEAVED
DAGALQS_2.pdb	UNCLEAVED
WALWLQS_3.pdb	UNCLEAVED
QVDYCQS_0.pdb	UNCLEAVED
LGRGMQS_0.pdb	UNCLEAVED
YAHLIQS_4.pdb	UNCLEAVED
RNYFIQS_3.pdb	UNCLEAVED
VPSGWQS_0.pdb	UNCLEAVED
CQSTTQS_3.pdb	UNCLEAVED
IYTSRQS_1.pdb	UNCLEAVED
WWVWDQS_1.pdb	UNCLEAVED
RSSSIQS_1.pdb	UNCLEAVED
SHGGAQS_2.pdb	UNCLEAVED
GLSGGQS_3.pdb	UNCLEAVED
LELSVQS_2.pdb	UNCLEAVED
FGWGTQS_4.pdb	UNCLEAVED
ALHSNQS_1.pdb	UNCLEAVED
DTRLRQS_1.pdb	UNCLEAVED
AYRSVQS_4.pdb	UNCLEAVED
LWQLLQS_3.pdb	UNCLEAVED
VSIRGQS_0.pdb	UNCLEAVED
CSGLRQS_2.pdb	UNCLEAVED
SGKVYQS_0.pdb	UNCLEAVED
YTFPVQS_0.pdb	UNCLEAVED
LSFLLQS_2.pdb	UNCLEAVED
PGTRVQS_0.pdb	UNCLEAVED
RWRFDQS_3.pdb	UNCLEAVED
TTMGRQS_4.pdb	UNCLEAVED
NSRSDQS_4.pdb	UNCLEAVED
ANWFLQS_4.pdb	UNCLEAVED
GCTSPQS_0.pdb	UNCLEAVED
WDTSRQS_3.pdb	UNCLEAVED
NRGVGQS_2.pdb	UNCLEAVED
NGGGHQS_3.pdb	UNCLEAVED
TVGRSQS_0.pdb	UNCLEAVED
EWLVLQS_3.pdb	UNCLEAVED
NVPLSQS_4.pdb	UNCLEAVED
TSARDQS_2.pdb	UNCLEAVED
GGDWPQS_4.pdb	UNCLEAVED
LVWCSQS_3.pdb	UNCLEAVED
NLSTLQS_4.pdb	UNCLEAVED
GDNMGQS_3.pdb	UNCLEAVED
WRSAVQS_2.pdb	UNCLEAVED
VTHDQQS_0.pdb	UNCLEAVED
DGRWSQS_1.pdb	UNCLEAVED
GTRGTQS_1.pdb	UNCLEAVED
RDTAGQS_1.pdb	UNCLEAVED
EMYLAQS_3.pdb	UNCLEAVED
VNVPRQS_2.pdb	UNCLEAVED
RGSDSQS_1.pdb	UNCLEAVED
AVLGMQS_4.pdb	UNCLEAVED
FGYSGQS_3.pdb	UNCLEAVED
WAHWCQS_0.pdb	UNCLEAVED
RAWLDQS_4.pdb	UNCLEAVED
LGFERQS_4.pdb	UNCLEAVED
YERPLQS_1.pdb	UNCLEAVED
LMRWNQS_3.pdb	UNCLEAVED
FEFVAQS_4.pdb	UNCLEAVED
CRPAAQS_3.pdb	UNCLEAVED
AGRECQS_4.pdb	UNCLEAVED
LCYTNQS_1.pdb	UNCLEAVED
WNLWPQS_4.pdb	UNCLEAVED
LCPHCQS_4.pdb	UNCLEAVED
GCYTKQS_4.pdb	UNCLEAVED
MVGSRQS_4.pdb	UNCLEAVED
DSDARQS_3.pdb	UNCLEAVED
KTIGSQS_0.pdb	UNCLEAVED
IMPKSQS_3.pdb	UNCLEAVED
WVRNPQS_3.pdb	UNCLEAVED
ELWGWQS_0.pdb	UNCLEAVED
SGMWVQS_0.pdb	UNCLEAVED
TLRLVQS_0.pdb	UNCLEAVED
PYSGGQS_1.pdb	UNCLEAVED
STSKEQS_2.pdb	UNCLEAVED
GRQSSQS_0.pdb	UNCLEAVED
ASFKCQS_1.pdb	UNCLEAVED
FGYAGQS_3.pdb	UNCLEAVED
LADNPQS_4.pdb	UNCLEAVED
PGWEEQS_2.pdb	UNCLEAVED
SWTGRQS_1.pdb	UNCLEAVED
LGSPVQS_3.pdb	UNCLEAVED
GSRVKQS_1.pdb	UNCLEAVED
GNDFRQS_3.pdb	UNCLEAVED
GSDYDQS_0.pdb	UNCLEAVED
DRCQDQS_2.pdb	UNCLEAVED
ITSTTQS_0.pdb	UNCLEAVED
SYRLYQS_0.pdb	UNCLEAVED
YVWAGQS_4.pdb	UNCLEAVED
LGYGGQS_0.pdb	UNCLEAVED
NLLLLQS_0.pdb	UNCLEAVED
RSLSIQS_1.pdb	UNCLEAVED
RNWSSQS_0.pdb	UNCLEAVED
IISGSQS_2.pdb	UNCLEAVED
YYWDYQS_0.pdb	UNCLEAVED
THDVKQS_4.pdb	UNCLEAVED
CVSSRQS_3.pdb	UNCLEAVED
EFRVGQS_3.pdb	UNCLEAVED
ACLGLQS_0.pdb	UNCLEAVED
VRMIVQS_4.pdb	UNCLEAVED
CTSLHQS_0.pdb	UNCLEAVED
LVVGGQS_4.pdb	UNCLEAVED
PSFFSQS_4.pdb	UNCLEAVED
RAHPWQS_2.pdb	UNCLEAVED
CCCPDQS_3.pdb	UNCLEAVED
MMSPNQS_1.pdb	UNCLEAVED
QPDHIQS_3.pdb	UNCLEAVED
LVHLRQS_0.pdb	UNCLEAVED
YSFNCQS_1.pdb	UNCLEAVED
CTWIKQS_2.pdb	UNCLEAVED
PNVGRQS_2.pdb	UNCLEAVED
GLGADQS_4.pdb	UNCLEAVED
SGSRPQS_3.pdb	UNCLEAVED
SWQRHQS_1.pdb	UNCLEAVED
LFWKSQS_0.pdb	UNCLEAVED
CTLERQS_1.pdb	UNCLEAVED
YFKIIQS_0.pdb	UNCLEAVED
VRFNWQS_1.pdb	UNCLEAVED
SPGGYQS_3.pdb	UNCLEAVED
KGKSTQS_3.pdb	UNCLEAVED
SGMENQS_1.pdb	UNCLEAVED
APDLGQS_0.pdb	UNCLEAVED
CSSDLQS_1.pdb	UNCLEAVED
LVMLGQS_2.pdb	UNCLEAVED
HRSSLQS_3.pdb	UNCLEAVED
WSHLRQS_3.pdb	UNCLEAVED
NPLAHQS_2.pdb	UNCLEAVED
SHMWNQS_0.pdb	UNCLEAVED
YLLRGQS_3.pdb	UNCLEAVED
RGVTGQS_2.pdb	UNCLEAVED
MIYAIQS_2.pdb	UNCLEAVED
CEYNIQS_4.pdb	UNCLEAVED
RPMAVQS_1.pdb	UNCLEAVED
SRGGSQS_2.pdb	UNCLEAVED
WSCGGQS_2.pdb	UNCLEAVED
YSFTRQS_1.pdb	UNCLEAVED
ASLGVQS_3.pdb	UNCLEAVED
GNSGVQS_0.pdb	UNCLEAVED
CGSVSQS_1.pdb	UNCLEAVED
SFEGTQS_0.pdb	UNCLEAVED
SVKLDQS_2.pdb	UNCLEAVED
PNSAHQS_4.pdb	UNCLEAVED
SWWVIQS_4.pdb	UNCLEAVED
LRHWPQS_2.pdb	UNCLEAVED
TGMLLQS_3.pdb	UNCLEAVED
LWRSCQS_3.pdb	UNCLEAVED
ACPRGQS_2.pdb	UNCLEAVED
PSNPGQS_1.pdb	UNCLEAVED
LGSGIQS_3.pdb	UNCLEAVED
VDVGAQS_0.pdb	UNCLEAVED
GFRLSQS_4.pdb	UNCLEAVED
KHLNHQS_4.pdb	UNCLEAVED
LIRPVQS_4.pdb	UNCLEAVED
QYINNQS_4.pdb	UNCLEAVED
PPGNCQS_2.pdb	UNCLEAVED
REGYDQS_3.pdb	UNCLEAVED
ESNMCQS_3.pdb	UNCLEAVED
GRQVAQS_0.pdb	UNCLEAVED
VCGLDQS_3.pdb	UNCLEAVED
WGRTKQS_0.pdb	UNCLEAVED
DGAGIQS_3.pdb	UNCLEAVED
VAFFAQS_3.pdb	UNCLEAVED
YLSCLQS_1.pdb	UNCLEAVED
WGQDYQS_4.pdb	UNCLEAVED
INCYGQS_0.pdb	UNCLEAVED
VWVLSQS_0.pdb	UNCLEAVED
GSVGGQS_0.pdb	UNCLEAVED
LRTGVQS_3.pdb	UNCLEAVED
VLGRTQS_4.pdb	UNCLEAVED
CFNEAQS_1.pdb	UNCLEAVED
SGLIVQS_0.pdb	UNCLEAVED
SFNAAQS_3.pdb	UNCLEAVED
CLNPVQS_4.pdb	UNCLEAVED
HYRGQQS_3.pdb	UNCLEAVED
GFPSSQS_2.pdb	UNCLEAVED
STYNKQS_4.pdb	UNCLEAVED
SEYLRQS_0.pdb	UNCLEAVED
RGTPGQS_0.pdb	UNCLEAVED
RGWSHQS_3.pdb	UNCLEAVED
RGLTLQS_2.pdb	UNCLEAVED
DGFQCQS_0.pdb	UNCLEAVED
WCGEEQS_1.pdb	UNCLEAVED
ASSSNQS_3.pdb	UNCLEAVED
SIDVPQS_3.pdb	UNCLEAVED
IGSQVQS_1.pdb	UNCLEAVED
YVSVVQS_1.pdb	UNCLEAVED
GSPNGQS_3.pdb	UNCLEAVED
MGLPSQS_1.pdb	UNCLEAVED
CGTMCQS_3.pdb	UNCLEAVED
YMSICQS_1.pdb	UNCLEAVED
GGQGRQS_2.pdb	UNCLEAVED
WEAPWQS_2.pdb	UNCLEAVED
VFLNPQS_4.pdb	UNCLEAVED
RIYVIQS_0.pdb	UNCLEAVED
IIQYRQS_1.pdb	UNCLEAVED
FVDVRQS_1.pdb	UNCLEAVED
PGFYAQS_4.pdb	UNCLEAVED
AWKIVQS_4.pdb	UNCLEAVED
HMGTSQS_0.pdb	UNCLEAVED
MSCSRQS_0.pdb	UNCLEAVED
TVPLVQS_3.pdb	UNCLEAVED
KLGSVQS_2.pdb	UNCLEAVED
DPGNLQS_1.pdb	UNCLEAVED
ATGLVQS_1.pdb	UNCLEAVED
LPDGGQS_4.pdb	UNCLEAVED
YMYHSQS_2.pdb	UNCLEAVED
SVLGMQS_3.pdb	UNCLEAVED
GWNTGQS_2.pdb	UNCLEAVED
IPLYPQS_1.pdb	UNCLEAVED
CYSSCQS_1.pdb	UNCLEAVED
VSSGSQS_1.pdb	UNCLEAVED
MVGSTQS_0.pdb	UNCLEAVED
YLLYDQS_2.pdb	UNCLEAVED
GYRPHQS_3.pdb	UNCLEAVED
DGYLVQS_3.pdb	UNCLEAVED
KQFPLQS_0.pdb	UNCLEAVED
TGTPIQS_3.pdb	UNCLEAVED
AERGGQS_1.pdb	UNCLEAVED
HNGFKQS_4.pdb	UNCLEAVED
NAFDDQS_2.pdb	UNCLEAVED
FTSVTQS_2.pdb	UNCLEAVED
FRGQGQS_2.pdb	UNCLEAVED
HCVKSQS_3.pdb	UNCLEAVED
GRGKGQS_1.pdb	UNCLEAVED
VGCCPQS_0.pdb	UNCLEAVED
CSLGNQS_3.pdb	UNCLEAVED
LGRCLQS_1.pdb	UNCLEAVED
RISALQS_3.pdb	UNCLEAVED
SGYVIQS_3.pdb	UNCLEAVED
TCSPWQS_3.pdb	UNCLEAVED
TTLQIQS_3.pdb	UNCLEAVED
FCAAQQS_3.pdb	UNCLEAVED
GALRLQS_0.pdb	UNCLEAVED
FSFQLQS_0.pdb	UNCLEAVED
KCIVDQS_4.pdb	UNCLEAVED
YCLSDQS_0.pdb	UNCLEAVED
WWYLNQS_0.pdb	UNCLEAVED
LPRVAQS_1.pdb	UNCLEAVED
GVNMSQS_3.pdb	UNCLEAVED
WVSSDQS_3.pdb	UNCLEAVED
RNFFSQS_3.pdb	UNCLEAVED
WQAVTQS_3.pdb	UNCLEAVED
LSPLLQS_0.pdb	UNCLEAVED
SKTSDQS_3.pdb	UNCLEAVED
TTSTSQS_0.pdb	UNCLEAVED
SGAGPQS_3.pdb	UNCLEAVED
LSRVMQS_4.pdb	UNCLEAVED
SGRRKQS_0.pdb	UNCLEAVED
GKMGRQS_2.pdb	UNCLEAVED
YRKFWQS_4.pdb	UNCLEAVED
KRNVTQS_0.pdb	UNCLEAVED
KAHVTQS_1.pdb	UNCLEAVED
QGGRVQS_1.pdb	UNCLEAVED
ENYQVQS_1.pdb	UNCLEAVED
CGDFLQS_0.pdb	UNCLEAVED
HNAVGQS_0.pdb	UNCLEAVED
MAYRNQS_3.pdb	UNCLEAVED
LGYNIQS_1.pdb	UNCLEAVED
SLRSKQS_3.pdb	UNCLEAVED
GPSCDQS_3.pdb	UNCLEAVED
CVHGFQS_4.pdb	UNCLEAVED
RPLLVQS_3.pdb	UNCLEAVED
AFFGWQS_2.pdb	UNCLEAVED
LRGSRQS_1.pdb	UNCLEAVED
CVLLRQS_0.pdb	UNCLEAVED
VLTYVQS_0.pdb	UNCLEAVED
RCASAQS_1.pdb	UNCLEAVED
HTLYDQS_2.pdb	UNCLEAVED
IGILNQS_4.pdb	UNCLEAVED
LYLKHQS_2.pdb	UNCLEAVED
WSVDTQS_3.pdb	UNCLEAVED
RPSFAQS_3.pdb	UNCLEAVED
VTYSCQS_2.pdb	UNCLEAVED
SKHLHQS_1.pdb	UNCLEAVED
RSNTGQS_1.pdb	UNCLEAVED
GPGFSQS_1.pdb	UNCLEAVED
YCAMSQS_3.pdb	UNCLEAVED
