Sequence	Result
LESLLEG_1.pdb	CLEAVED
LGWGFEG_0.pdb	CLEAVED
FEVLFEG_2.pdb	CLEAVED
HAWWWEG_2.pdb	CLEAVED
YLYMREG_0.pdb	CLEAVED
LCSWLEG_1.pdb	CLEAVED
SVEYYEG_4.pdb	CLEAVED
FDRLFEG_3.pdb	CLEAVED
WVPFFEG_4.pdb	CLEAVED
IIDMYEG_3.pdb	CLEAVED
NVIFYEG_2.pdb	CLEAVED
LSWFLEG_2.pdb	CLEAVED
YSWLYEG_3.pdb	CLEAVED
FHIFLEG_0.pdb	CLEAVED
VTIWYEG_1.pdb	CLEAVED
LWVYMEG_3.pdb	CLEAVED
PSWRFEG_2.pdb	CLEAVED
TQDMFEG_0.pdb	CLEAVED
MSTYLEG_0.pdb	CLEAVED
GMFFLEG_3.pdb	CLEAVED
FLPFYEG_0.pdb	CLEAVED
LLSMYEG_0.pdb	CLEAVED
LVGLWEG_1.pdb	CLEAVED
LNELYEG_0.pdb	CLEAVED
PFLLFEG_0.pdb	CLEAVED
VVSFHEG_2.pdb	CLEAVED
WDYSREG_1.pdb	CLEAVED
FVTLLEG_2.pdb	CLEAVED
MGLFFEG_0.pdb	CLEAVED
FIAFFEG_3.pdb	CLEAVED
RVWWHEG_3.pdb	CLEAVED
VLWFLEG_0.pdb	CLEAVED
QFWELEG_2.pdb	CLEAVED
ILGYFEG_1.pdb	CLEAVED
YFFMYEG_0.pdb	CLEAVED
LIFLYEG_4.pdb	CLEAVED
SRLFWEG_1.pdb	CLEAVED
FGMLYEG_4.pdb	CLEAVED
FFAYFEG_1.pdb	CLEAVED
FLWRYEG_4.pdb	CLEAVED
VLWFYEG_3.pdb	CLEAVED
MYWDFEG_4.pdb	CLEAVED
WIVWMEG_3.pdb	CLEAVED
HGLFLEG_0.pdb	CLEAVED
WVGYWEG_1.pdb	CLEAVED
GAEFWEG_1.pdb	CLEAVED
LYAYLEG_1.pdb	CLEAVED
GWWLLEG_1.pdb	CLEAVED
RFFAREG_4.pdb	CLEAVED
SWWCYEG_1.pdb	CLEAVED
LCSFMEG_1.pdb	CLEAVED
MLRMLEG_2.pdb	CLEAVED
VFVRNEG_4.pdb	CLEAVED
LWLANEG_0.pdb	CLEAVED
HAWDFEG_4.pdb	CLEAVED
FNWRYEG_4.pdb	CLEAVED
LISLYEG_4.pdb	CLEAVED
PIYWLEG_1.pdb	CLEAVED
KRALYEG_2.pdb	CLEAVED
FAIWFEG_0.pdb	CLEAVED
IKRYYEG_2.pdb	CLEAVED
YVYLLEG_0.pdb	CLEAVED
IYYYLEG_1.pdb	CLEAVED
LMWSFEG_4.pdb	CLEAVED
VGVFWEG_2.pdb	CLEAVED
NVCLREG_1.pdb	CLEAVED
MMIFYEG_4.pdb	CLEAVED
HSQYLEG_4.pdb	CLEAVED
KLIYFEG_0.pdb	CLEAVED
VASLLEG_0.pdb	CLEAVED
VVAYHEG_4.pdb	CLEAVED
DAVYSEG_0.pdb	CLEAVED
WSRWFEG_2.pdb	CLEAVED
LSLLLEG_2.pdb	CLEAVED
KRMWLEG_4.pdb	CLEAVED
FASYLEG_4.pdb	CLEAVED
MSYWWEG_2.pdb	CLEAVED
SGVFFEG_2.pdb	CLEAVED
VTWSLEG_4.pdb	CLEAVED
IVKLYEG_1.pdb	CLEAVED
YPWWLEG_2.pdb	CLEAVED
LSCFLEG_2.pdb	CLEAVED
VSLFHEG_3.pdb	CLEAVED
YAWSLEG_2.pdb	CLEAVED
DIYYLEG_2.pdb	CLEAVED
VSWSFEG_4.pdb	CLEAVED
AVFFFEG_0.pdb	CLEAVED
DVRKREG_3.pdb	CLEAVED
GLEYFEG_2.pdb	CLEAVED
MDCYLEG_4.pdb	CLEAVED
YFWELEG_0.pdb	CLEAVED
VDWGFEG_1.pdb	CLEAVED
FSRLYEG_4.pdb	CLEAVED
MYGLLEG_2.pdb	CLEAVED
FWWLFEG_0.pdb	CLEAVED
HLSYMEG_2.pdb	CLEAVED
YVLFLEG_3.pdb	CLEAVED
STYYYEG_2.pdb	CLEAVED
LEVMYEG_1.pdb	CLEAVED
WYVFLEG_3.pdb	CLEAVED
YKVLYEG_1.pdb	CLEAVED
FHYMLEG_3.pdb	CLEAVED
LTDYWEG_4.pdb	CLEAVED
FWRLFEG_1.pdb	CLEAVED
SVLFFEG_1.pdb	CLEAVED
GNLFYEG_4.pdb	CLEAVED
DSTFLEG_1.pdb	CLEAVED
MSIWWEG_2.pdb	CLEAVED
LVVSPEG_0.pdb	CLEAVED
YNSFMEG_2.pdb	CLEAVED
IVPFMEG_2.pdb	CLEAVED
VVGLWEG_0.pdb	CLEAVED
LMAYFEG_4.pdb	CLEAVED
VLRYHEG_4.pdb	CLEAVED
SVVFFEG_3.pdb	CLEAVED
EFVYLEG_2.pdb	CLEAVED
YLRVREG_3.pdb	CLEAVED
FHRRTEG_3.pdb	CLEAVED
YMTLLEG_0.pdb	CLEAVED
ASYFLEG_0.pdb	CLEAVED
VKHMLEG_3.pdb	CLEAVED
HLWWLEG_3.pdb	CLEAVED
WELHYEG_2.pdb	CLEAVED
FGVMLEG_3.pdb	CLEAVED
LRVFWEG_4.pdb	CLEAVED
SHAFLEG_0.pdb	CLEAVED
NIWYWEG_0.pdb	CLEAVED
KLSYLEG_1.pdb	CLEAVED
VMRFREG_4.pdb	CLEAVED
FHHLYEG_1.pdb	CLEAVED
SSSFYEG_0.pdb	CLEAVED
YETLYEG_0.pdb	CLEAVED
WGLMLEG_2.pdb	CLEAVED
QFSLYEG_1.pdb	CLEAVED
WGVYWEG_2.pdb	CLEAVED
FGWSWEG_2.pdb	CLEAVED
VAVLFEG_4.pdb	CLEAVED
LVWMFEG_2.pdb	CLEAVED
GGQYFEG_3.pdb	CLEAVED
DDMFLEG_2.pdb	CLEAVED
QVGWYEG_2.pdb	CLEAVED
PIRYLEG_1.pdb	CLEAVED
LFEYHEG_1.pdb	CLEAVED
ARGYLEG_1.pdb	CLEAVED
SLVWLEG_4.pdb	CLEAVED
LYNMYEG_3.pdb	CLEAVED
FLFFYEG_2.pdb	CLEAVED
RDVFLEG_2.pdb	CLEAVED
LESGLEG_2.pdb	CLEAVED
WLLFLEG_0.pdb	CLEAVED
LPYLFEG_4.pdb	CLEAVED
VLPFLEG_2.pdb	CLEAVED
DGYFLEG_4.pdb	CLEAVED
LVWYPEG_1.pdb	CLEAVED
FGHLFEG_2.pdb	CLEAVED
SFWTLEG_2.pdb	CLEAVED
VHRLYEG_4.pdb	CLEAVED
HKVWWEG_4.pdb	CLEAVED
WAGMTEG_3.pdb	CLEAVED
LSFGFEG_1.pdb	CLEAVED
CGAYCEG_4.pdb	CLEAVED
LQGFLEG_0.pdb	CLEAVED
RARLLEG_1.pdb	CLEAVED
LSFNFEG_4.pdb	CLEAVED
VSFVDEG_3.pdb	CLEAVED
YGMLLEG_2.pdb	CLEAVED
RFGYFEG_2.pdb	CLEAVED
LSLHWEG_3.pdb	CLEAVED
FVWLFEG_0.pdb	CLEAVED
QLWIYEG_3.pdb	CLEAVED
HDVYLEG_4.pdb	CLEAVED
WIGWFEG_3.pdb	CLEAVED
VLMYLEG_1.pdb	CLEAVED
VFFQYEG_2.pdb	CLEAVED
LMTMLEG_1.pdb	CLEAVED
FLIFLEG_3.pdb	CLEAVED
LVALFEG_0.pdb	CLEAVED
LCDLMEG_4.pdb	CLEAVED
YLVLLEG_0.pdb	CLEAVED
FVYMFEG_0.pdb	CLEAVED
LDVLFEG_1.pdb	CLEAVED
YACFFEG_2.pdb	CLEAVED
TYGFFEG_3.pdb	CLEAVED
LWVLYEG_1.pdb	CLEAVED
YAWKFEG_0.pdb	CLEAVED
MFDLMEG_0.pdb	CLEAVED
FLFFLEG_4.pdb	CLEAVED
FSLYAEG_1.pdb	CLEAVED
SVGFYEG_4.pdb	CLEAVED
WLFLLEG_0.pdb	CLEAVED
LLFSLEG_2.pdb	CLEAVED
STGFLEG_3.pdb	CLEAVED
ASEWLEG_1.pdb	CLEAVED
YYNWFEG_1.pdb	CLEAVED
KVSLLEG_3.pdb	CLEAVED
VLFLLEG_2.pdb	CLEAVED
GLGYNEG_2.pdb	CLEAVED
LGSLLEG_3.pdb	CLEAVED
LGSLPEG_1.pdb	CLEAVED
FYWYYEG_4.pdb	CLEAVED
VRVWLEG_3.pdb	CLEAVED
YFSLLEG_3.pdb	CLEAVED
VGSLLEG_4.pdb	CLEAVED
GCLVNEG_0.pdb	CLEAVED
RGWSLEG_1.pdb	CLEAVED
SFIMLEG_3.pdb	CLEAVED
YTVFYEG_0.pdb	CLEAVED
YIRVLEG_1.pdb	CLEAVED
KVWYLEG_2.pdb	CLEAVED
IFHHLEG_1.pdb	CLEAVED
LVLFYEG_1.pdb	CLEAVED
APWWWEG_4.pdb	CLEAVED
VLVMYEG_0.pdb	CLEAVED
LGDLWEG_1.pdb	CLEAVED
LWWWLEG_1.pdb	CLEAVED
LACCAEG_0.pdb	CLEAVED
LNDMNEG_0.pdb	CLEAVED
MVGMWEG_3.pdb	CLEAVED
ADTYLEG_0.pdb	CLEAVED
LSTLLEG_0.pdb	CLEAVED
FSQWLEG_4.pdb	CLEAVED
LSDWWEG_1.pdb	CLEAVED
VLVRREG_0.pdb	CLEAVED
VGWWYEG_1.pdb	CLEAVED
LAFWFEG_1.pdb	CLEAVED
LYGMWEG_0.pdb	CLEAVED
IRLWFEG_1.pdb	CLEAVED
MLAFLEG_0.pdb	CLEAVED
EIWVYEG_4.pdb	CLEAVED
IRFFLEG_2.pdb	CLEAVED
VLWWLEG_2.pdb	CLEAVED
LSSHYEG_3.pdb	CLEAVED
SPVRYEG_2.pdb	CLEAVED
IGWMLEG_4.pdb	CLEAVED
MDWALEG_0.pdb	CLEAVED
LLWTLEG_3.pdb	CLEAVED
LTGMWEG_1.pdb	CLEAVED
LLWWMEG_0.pdb	CLEAVED
VSQLWEG_2.pdb	CLEAVED
PLRFFEG_3.pdb	CLEAVED
LVWWLEG_1.pdb	CLEAVED
LEGEVEG_2.pdb	CLEAVED
WEVLWEG_3.pdb	CLEAVED
RVIPLEG_2.pdb	CLEAVED
LAYMFEG_1.pdb	CLEAVED
VGWGWEG_2.pdb	CLEAVED
LTLYWEG_3.pdb	CLEAVED
LCTLLEG_3.pdb	CLEAVED
LRVWWEG_3.pdb	CLEAVED
ETWNYEG_1.pdb	CLEAVED
HFLYWEG_1.pdb	CLEAVED
VMVFWEG_0.pdb	CLEAVED
WVVGYEG_2.pdb	CLEAVED
VWSFFEG_2.pdb	CLEAVED
IMHLMEG_1.pdb	CLEAVED
ILDLFEG_2.pdb	CLEAVED
YREYWEG_2.pdb	CLEAVED
NIAYFEG_2.pdb	CLEAVED
YKHMLEG_3.pdb	CLEAVED
LSVLWEG_1.pdb	CLEAVED
LGWSWEG_3.pdb	CLEAVED
YVSMYEG_2.pdb	CLEAVED
YRILFEG_1.pdb	CLEAVED
WHYLFEG_2.pdb	CLEAVED
YGCFLEG_4.pdb	CLEAVED
YSWGSEG_1.pdb	CLEAVED
VHRRWEG_2.pdb	CLEAVED
CPCFLEG_2.pdb	CLEAVED
WSAMLEG_1.pdb	CLEAVED
WLGLMEG_1.pdb	CLEAVED
LGWVLEG_1.pdb	CLEAVED
YWFRFEG_3.pdb	CLEAVED
QFWWWEG_1.pdb	CLEAVED
LHWMMEG_1.pdb	CLEAVED
TACYFEG_1.pdb	CLEAVED
NLFMLEG_1.pdb	CLEAVED
QHVIFEG_3.pdb	CLEAVED
FAVWFEG_3.pdb	CLEAVED
GMIYYEG_2.pdb	CLEAVED
LSNWWEG_3.pdb	CLEAVED
YDVGCEG_3.pdb	CLEAVED
GPFVDEG_1.pdb	CLEAVED
LGGMLEG_4.pdb	CLEAVED
FPAYLEG_4.pdb	CLEAVED
YKTMLEG_2.pdb	CLEAVED
LRAKREG_1.pdb	CLEAVED
FFGMAEG_3.pdb	CLEAVED
RFNFLEG_1.pdb	CLEAVED
WNRFYEG_3.pdb	CLEAVED
WAVLYEG_2.pdb	CLEAVED
LRVRLEG_1.pdb	CLEAVED
VKSLYEG_4.pdb	CLEAVED
FSPWLEG_3.pdb	CLEAVED
MTDLWEG_2.pdb	CLEAVED
TMVYYEG_0.pdb	CLEAVED
RVSYYEG_0.pdb	CLEAVED
LCVFLEG_0.pdb	CLEAVED
YWMLWEG_1.pdb	CLEAVED
WWSYYEG_4.pdb	CLEAVED
PKWWLEG_4.pdb	CLEAVED
LSLSTEG_2.pdb	CLEAVED
VRWVYEG_3.pdb	CLEAVED
IDCFFEG_4.pdb	CLEAVED
FRHWFEG_1.pdb	CLEAVED
WLTLFEG_2.pdb	CLEAVED
DVIDFEG_1.pdb	CLEAVED
LVYYLEG_2.pdb	CLEAVED
RSQWLEG_4.pdb	CLEAVED
IRRMYEG_1.pdb	CLEAVED
FKVMYEG_3.pdb	CLEAVED
LYWFVEG_0.pdb	CLEAVED
FGVVLEG_1.pdb	CLEAVED
PSAFLEG_0.pdb	CLEAVED
CSQFYEG_1.pdb	CLEAVED
FRSLFEG_2.pdb	CLEAVED
CSWSLEG_2.pdb	CLEAVED
SVVSSEG_4.pdb	CLEAVED
MYVWFEG_1.pdb	CLEAVED
VFGLLEG_1.pdb	CLEAVED
MPWWMEG_2.pdb	CLEAVED
MVWDWEG_3.pdb	CLEAVED
VVRWWEG_4.pdb	CLEAVED
YWWYLEG_2.pdb	CLEAVED
VAPLKEG_1.pdb	CLEAVED
CTWWLEG_2.pdb	CLEAVED
TYWVYEG_1.pdb	CLEAVED
AEWELEG_0.pdb	CLEAVED
LYGFWEG_2.pdb	CLEAVED
IIWNFEG_1.pdb	CLEAVED
MLWSFEG_1.pdb	CLEAVED
SVWQYEG_1.pdb	CLEAVED
LCSMLEG_4.pdb	CLEAVED
WTRLLEG_2.pdb	CLEAVED
WAGFWEG_0.pdb	CLEAVED
YMSLWEG_0.pdb	CLEAVED
ILAYYEG_2.pdb	CLEAVED
LGQFLEG_1.pdb	CLEAVED
WDLILEG_0.pdb	CLEAVED
FIMHFEG_4.pdb	CLEAVED
RLVVVEG_0.pdb	CLEAVED
TFRYLEG_4.pdb	CLEAVED
LLLFHEG_0.pdb	CLEAVED
LGPFLEG_4.pdb	CLEAVED
TDIFREG_1.pdb	CLEAVED
CCFWYEG_3.pdb	CLEAVED
NRVFLEG_0.pdb	CLEAVED
LMMLWEG_0.pdb	CLEAVED
VLIFHEG_1.pdb	CLEAVED
ILMFWEG_3.pdb	CLEAVED
NMKFLEG_2.pdb	CLEAVED
FATFLEG_0.pdb	CLEAVED
WGWVFEG_2.pdb	CLEAVED
IASMFEG_4.pdb	CLEAVED
VPWMWEG_3.pdb	CLEAVED
LPALYEG_3.pdb	CLEAVED
ISCLYEG_1.pdb	CLEAVED
WMSFWEG_0.pdb	CLEAVED
LSNHFEG_0.pdb	CLEAVED
LRIFHEG_3.pdb	CLEAVED
FIRLFEG_2.pdb	CLEAVED
WWFQFEG_1.pdb	CLEAVED
LCQWWEG_1.pdb	CLEAVED
MLLWFEG_1.pdb	CLEAVED
FGFGFEG_3.pdb	CLEAVED
SWWFWEG_3.pdb	CLEAVED
YHWPMEG_4.pdb	CLEAVED
TLCDREG_2.pdb	CLEAVED
VFPWFEG_2.pdb	CLEAVED
YQFGLEG_2.pdb	CLEAVED
WEGMVEG_4.pdb	CLEAVED
IACYWEG_0.pdb	CLEAVED
RSSYLEG_1.pdb	CLEAVED
FVAWLEG_3.pdb	CLEAVED
LRTHYEG_1.pdb	CLEAVED
WALCLEG_1.pdb	CLEAVED
PSLFLEG_2.pdb	CLEAVED
PIRQLEG_0.pdb	CLEAVED
NVILVEG_1.pdb	CLEAVED
FYKLYEG_2.pdb	CLEAVED
ERWMLEG_1.pdb	CLEAVED
MAVLFEG_2.pdb	CLEAVED
CLGFCEG_2.pdb	CLEAVED
ESVMFEG_3.pdb	CLEAVED
ILGWFEG_3.pdb	CLEAVED
IKFLWEG_4.pdb	CLEAVED
SCCFFEG_1.pdb	CLEAVED
FWWCLEG_1.pdb	CLEAVED
SVVTTEG_2.pdb	CLEAVED
VSDWLEG_1.pdb	CLEAVED
LEFAYEG_0.pdb	CLEAVED
MHGLLEG_4.pdb	CLEAVED
QECLFEG_2.pdb	CLEAVED
IIFLMEG_4.pdb	CLEAVED
PWYWFEG_4.pdb	CLEAVED
VLGWLEG_4.pdb	CLEAVED
VEECWEG_4.pdb	CLEAVED
IVQLLEG_2.pdb	CLEAVED
HDGLLEG_3.pdb	CLEAVED
VAPMLEG_4.pdb	CLEAVED
WVNGSEG_0.pdb	CLEAVED
LFFWHEG_0.pdb	CLEAVED
VTSMWEG_1.pdb	CLEAVED
RGQWLEG_1.pdb	CLEAVED
YLEGGEG_3.pdb	CLEAVED
YVCFLEG_2.pdb	CLEAVED
NVSMLEG_2.pdb	CLEAVED
ICQWLEG_2.pdb	CLEAVED
RRRLFEG_1.pdb	CLEAVED
LVTWLEG_0.pdb	CLEAVED
FVPLLEG_0.pdb	CLEAVED
ASMWLEG_1.pdb	CLEAVED
CVWQFEG_1.pdb	CLEAVED
LVAIYEG_1.pdb	CLEAVED
YLVQFEG_2.pdb	CLEAVED
CTEYYEG_3.pdb	CLEAVED
KRSLLEG_3.pdb	CLEAVED
LLMPREG_3.pdb	CLEAVED
LVLLLEG_3.pdb	CLEAVED
HCWYLEG_0.pdb	CLEAVED
HKLHLEG_3.pdb	CLEAVED
KFAFFEG_4.pdb	CLEAVED
LSACLEG_0.pdb	CLEAVED
SVSMYEG_2.pdb	CLEAVED
YRGFFEG_0.pdb	CLEAVED
WLDILEG_4.pdb	CLEAVED
TLLCYEG_2.pdb	CLEAVED
LAGCFEG_0.pdb	CLEAVED
FLALFEG_0.pdb	CLEAVED
WFLNLEG_3.pdb	CLEAVED
LCGLLEG_2.pdb	CLEAVED
FELNYEG_2.pdb	CLEAVED
NSWWIEG_4.pdb	CLEAVED
TFWGLEG_2.pdb	CLEAVED
LRWYPEG_3.pdb	CLEAVED
VRRWLEG_3.pdb	CLEAVED
VSVLLEG_2.pdb	CLEAVED
WSVGFEG_4.pdb	CLEAVED
LASWYEG_0.pdb	CLEAVED
WMIMFEG_3.pdb	CLEAVED
MSVMWEG_2.pdb	CLEAVED
YGWSLEG_2.pdb	CLEAVED
LYALLEG_2.pdb	CLEAVED
LGWLFEG_3.pdb	CLEAVED
GVAYLEG_1.pdb	CLEAVED
CFWQFEG_0.pdb	CLEAVED
YCSLFEG_4.pdb	CLEAVED
TIWLYEG_4.pdb	CLEAVED
YVGWWEG_4.pdb	CLEAVED
SGWLLEG_0.pdb	CLEAVED
LVMRMEG_2.pdb	CLEAVED
NFSWFEG_2.pdb	CLEAVED
CQCLFEG_4.pdb	CLEAVED
GAWQWEG_3.pdb	CLEAVED
LAMLLEG_2.pdb	CLEAVED
HLESDEG_2.pdb	CLEAVED
MDNYLEG_2.pdb	CLEAVED
VWPWLEG_3.pdb	CLEAVED
IAWRLEG_4.pdb	CLEAVED
WTVLYEG_2.pdb	CLEAVED
YVGLMEG_2.pdb	CLEAVED
QSLFLEG_3.pdb	CLEAVED
YQLLFEG_4.pdb	CLEAVED
WYTSYEG_4.pdb	CLEAVED
IRDWMEG_4.pdb	CLEAVED
FEPLLEG_0.pdb	CLEAVED
IWWEVEG_1.pdb	CLEAVED
EDMYYEG_1.pdb	CLEAVED
LTMKYEG_2.pdb	CLEAVED
NRDLLEG_0.pdb	CLEAVED
VMQWMEG_4.pdb	CLEAVED
EWPFYEG_3.pdb	CLEAVED
HRIWFEG_3.pdb	CLEAVED
WIVGYEG_0.pdb	CLEAVED
LVTLLEG_1.pdb	CLEAVED
VAAMMEG_4.pdb	CLEAVED
LWWWMEG_1.pdb	CLEAVED
SMLFLEG_4.pdb	CLEAVED
WRIVWEG_3.pdb	CLEAVED
VFALMEG_0.pdb	CLEAVED
MSNWLEG_2.pdb	CLEAVED
RDAMYEG_1.pdb	CLEAVED
SSPFYEG_0.pdb	CLEAVED
VRRGVEG_0.pdb	CLEAVED
WGVLLEG_0.pdb	CLEAVED
LVDLYEG_4.pdb	CLEAVED
VFPFCEG_2.pdb	CLEAVED
YMRWLEG_1.pdb	CLEAVED
IFVLMEG_1.pdb	CLEAVED
FQWCFEG_1.pdb	CLEAVED
SFVLFEG_1.pdb	CLEAVED
ITLMWEG_2.pdb	CLEAVED
CLPFFEG_1.pdb	CLEAVED
RERLLEG_1.pdb	CLEAVED
HCWFWEG_3.pdb	CLEAVED
FVHLLEG_0.pdb	CLEAVED
VTYLLEG_4.pdb	CLEAVED
YEVLLEG_0.pdb	CLEAVED
WCSFFEG_3.pdb	CLEAVED
YRQWMEG_2.pdb	CLEAVED
VHLHFEG_4.pdb	CLEAVED
WQYWWEG_0.pdb	CLEAVED
WTVSFEG_3.pdb	CLEAVED
VSCLYEG_2.pdb	CLEAVED
IWSVGEG_4.pdb	CLEAVED
VDVSVEG_1.pdb	CLEAVED
SVWGLEG_1.pdb	CLEAVED
LDFSFEG_4.pdb	CLEAVED
GQDMLEG_3.pdb	CLEAVED
YGGMMEG_4.pdb	CLEAVED
LPCWLEG_3.pdb	CLEAVED
MLRPPEG_0.pdb	CLEAVED
VRFNFEG_4.pdb	CLEAVED
YSGMGEG_1.pdb	CLEAVED
HVMLWEG_3.pdb	CLEAVED
LMMAFEG_1.pdb	CLEAVED
FLVSFEG_2.pdb	CLEAVED
YVVIIEG_2.pdb	CLEAVED
HLSWLEG_3.pdb	CLEAVED
IGPLLEG_4.pdb	CLEAVED
LCVMMEG_2.pdb	CLEAVED
RLSAREG_2.pdb	CLEAVED
RSLWFEG_4.pdb	CLEAVED
LWVLLEG_2.pdb	CLEAVED
NAVMFEG_1.pdb	CLEAVED
FLFWMEG_2.pdb	CLEAVED
LNWVLEG_0.pdb	CLEAVED
RDLFFEG_1.pdb	CLEAVED
SLWWPEG_1.pdb	CLEAVED
VYLLLEG_3.pdb	CLEAVED
WWVHAEG_2.pdb	CLEAVED
CSSWFEG_3.pdb	CLEAVED
LVCHREG_2.pdb	CLEAVED
LLVRLEG_0.pdb	CLEAVED
IYRWWEG_2.pdb	CLEAVED
RNVMYEG_0.pdb	CLEAVED
SQKRGEG_0.pdb	CLEAVED
VFSRDEG_4.pdb	CLEAVED
YSSLMEG_2.pdb	CLEAVED
WWRLREG_1.pdb	CLEAVED
VLECLEG_4.pdb	CLEAVED
SMVDVEG_1.pdb	CLEAVED
FRIWMEG_4.pdb	CLEAVED
MPCMLEG_2.pdb	CLEAVED
FDIAFEG_4.pdb	CLEAVED
TNDLFEG_1.pdb	UNCLEAVED
EGGSDEG_1.pdb	UNCLEAVED
WEPRSEG_2.pdb	UNCLEAVED
ICNSNEG_2.pdb	UNCLEAVED
YVSTHEG_1.pdb	UNCLEAVED
GRGWSEG_4.pdb	UNCLEAVED
KVLPEEG_4.pdb	UNCLEAVED
DSAGCEG_1.pdb	UNCLEAVED
SCACIEG_3.pdb	UNCLEAVED
VAHHSEG_0.pdb	UNCLEAVED
PWESGEG_4.pdb	UNCLEAVED
TMGGVEG_1.pdb	UNCLEAVED
KGSSVEG_2.pdb	UNCLEAVED
TQRIREG_4.pdb	UNCLEAVED
YAILLEG_3.pdb	UNCLEAVED
YGHLPEG_2.pdb	UNCLEAVED
WCRSVEG_4.pdb	UNCLEAVED
HELVGEG_3.pdb	UNCLEAVED
RWWGGEG_0.pdb	UNCLEAVED
CGSLIEG_3.pdb	UNCLEAVED
CPSKWEG_2.pdb	UNCLEAVED
DERGIEG_1.pdb	UNCLEAVED
CGQSSEG_1.pdb	UNCLEAVED
RSKAGEG_2.pdb	UNCLEAVED
GLDCAEG_4.pdb	UNCLEAVED
HGLSEEG_1.pdb	UNCLEAVED
CWVVGEG_3.pdb	UNCLEAVED
VASCPEG_0.pdb	UNCLEAVED
GGVVCEG_2.pdb	UNCLEAVED
LGGGIEG_0.pdb	UNCLEAVED
LIKGEEG_4.pdb	UNCLEAVED
SMGMGEG_2.pdb	UNCLEAVED
NGLASEG_4.pdb	UNCLEAVED
WHTRVEG_0.pdb	UNCLEAVED
CGWGDEG_3.pdb	UNCLEAVED
GWWVGEG_0.pdb	UNCLEAVED
CELQREG_2.pdb	UNCLEAVED
RMRVTEG_1.pdb	UNCLEAVED
TSRGGEG_3.pdb	UNCLEAVED
GTVWSEG_4.pdb	UNCLEAVED
YVMRSEG_1.pdb	UNCLEAVED
PACSCEG_4.pdb	UNCLEAVED
RWRAREG_4.pdb	UNCLEAVED
RCVWLEG_4.pdb	UNCLEAVED
RGVEREG_3.pdb	UNCLEAVED
KWYVVEG_2.pdb	UNCLEAVED
RGYEIEG_2.pdb	UNCLEAVED
HGRGWEG_4.pdb	UNCLEAVED
MGVCAEG_2.pdb	UNCLEAVED
SHIVGEG_3.pdb	UNCLEAVED
SDSMAEG_3.pdb	UNCLEAVED
RASVEEG_1.pdb	UNCLEAVED
KGQGMEG_3.pdb	UNCLEAVED
SLLRWEG_0.pdb	UNCLEAVED
YWLYPEG_2.pdb	UNCLEAVED
MLVMGEG_4.pdb	UNCLEAVED
SKVVTEG_1.pdb	UNCLEAVED
AVCGVEG_4.pdb	UNCLEAVED
LRCTVEG_2.pdb	UNCLEAVED
FWPAIEG_3.pdb	UNCLEAVED
GAAVPEG_4.pdb	UNCLEAVED
GWEIHEG_2.pdb	UNCLEAVED
YRHTVEG_3.pdb	UNCLEAVED
WPCCPEG_0.pdb	UNCLEAVED
PVMVVEG_3.pdb	UNCLEAVED
CNVVVEG_3.pdb	UNCLEAVED
QAASVEG_1.pdb	UNCLEAVED
TRKSIEG_3.pdb	UNCLEAVED
CDKCQEG_2.pdb	UNCLEAVED
CHWFGEG_3.pdb	UNCLEAVED
SDVIEEG_2.pdb	UNCLEAVED
ANAMGEG_1.pdb	UNCLEAVED
DSTWDEG_3.pdb	UNCLEAVED
RVRSREG_0.pdb	UNCLEAVED
WDLEVEG_0.pdb	UNCLEAVED
YRIEREG_3.pdb	UNCLEAVED
FVAGGEG_3.pdb	UNCLEAVED
SVASKEG_0.pdb	UNCLEAVED
CGKKCEG_1.pdb	UNCLEAVED
LVGHREG_1.pdb	UNCLEAVED
SVVVIEG_2.pdb	UNCLEAVED
PCMIVEG_3.pdb	UNCLEAVED
ARRKFEG_3.pdb	UNCLEAVED
GSRAMEG_3.pdb	UNCLEAVED
TLGEHEG_2.pdb	UNCLEAVED
MHPNCEG_1.pdb	UNCLEAVED
WIAVVEG_3.pdb	UNCLEAVED
WCSGVEG_1.pdb	UNCLEAVED
NAAPVEG_4.pdb	UNCLEAVED
RGGWSEG_2.pdb	UNCLEAVED
PLNVREG_1.pdb	UNCLEAVED
CCTTKEG_2.pdb	UNCLEAVED
RVGWSEG_3.pdb	UNCLEAVED
WSMGVEG_0.pdb	UNCLEAVED
KCITTEG_2.pdb	UNCLEAVED
SGYGTEG_0.pdb	UNCLEAVED
CGCGVEG_4.pdb	UNCLEAVED
IWEVREG_2.pdb	UNCLEAVED
CWMGQEG_0.pdb	UNCLEAVED
SASGNEG_2.pdb	UNCLEAVED
YRGGEEG_3.pdb	UNCLEAVED
RTGGPEG_0.pdb	UNCLEAVED
TSAGQEG_1.pdb	UNCLEAVED
CVGRREG_2.pdb	UNCLEAVED
CLLEVEG_2.pdb	UNCLEAVED
LSLGFEG_2.pdb	UNCLEAVED
EVGESEG_3.pdb	UNCLEAVED
KGGACEG_1.pdb	UNCLEAVED
ATVGREG_3.pdb	UNCLEAVED
RGGDCEG_0.pdb	UNCLEAVED
CVRLIEG_2.pdb	UNCLEAVED
CGCCREG_1.pdb	UNCLEAVED
ASRRVEG_0.pdb	UNCLEAVED
EWVRVEG_3.pdb	UNCLEAVED
RRTRVEG_4.pdb	UNCLEAVED
SFGPVEG_0.pdb	UNCLEAVED
YAICREG_3.pdb	UNCLEAVED
SMVPQEG_1.pdb	UNCLEAVED
WLLVNEG_4.pdb	UNCLEAVED
LRAWGEG_4.pdb	UNCLEAVED
FVQECEG_0.pdb	UNCLEAVED
FVYRGEG_1.pdb	UNCLEAVED
VCYGREG_0.pdb	UNCLEAVED
NGRVPEG_0.pdb	UNCLEAVED
ELLCVEG_3.pdb	UNCLEAVED
CMYRVEG_4.pdb	UNCLEAVED
PAGPVEG_1.pdb	UNCLEAVED
RASGIEG_3.pdb	UNCLEAVED
YVGGDEG_0.pdb	UNCLEAVED
SSGWREG_1.pdb	UNCLEAVED
CGRVIEG_3.pdb	UNCLEAVED
LLGAREG_0.pdb	UNCLEAVED
WRGSGEG_4.pdb	UNCLEAVED
EKVAREG_2.pdb	UNCLEAVED
LCWVDEG_3.pdb	UNCLEAVED
LVQIIEG_0.pdb	UNCLEAVED
QLLNVEG_1.pdb	UNCLEAVED
GSTSAEG_1.pdb	UNCLEAVED
LGMGTEG_2.pdb	UNCLEAVED
CRWFGEG_4.pdb	UNCLEAVED
GVWVAEG_4.pdb	UNCLEAVED
CREVMEG_0.pdb	UNCLEAVED
AGPCGEG_4.pdb	UNCLEAVED
AEANREG_4.pdb	UNCLEAVED
FLRALEG_0.pdb	UNCLEAVED
CAFFREG_3.pdb	UNCLEAVED
LVGGEEG_4.pdb	UNCLEAVED
AGRNVEG_3.pdb	UNCLEAVED
RGRGEEG_4.pdb	UNCLEAVED
ARSVPEG_4.pdb	UNCLEAVED
YSAGREG_3.pdb	UNCLEAVED
FNMVVEG_1.pdb	UNCLEAVED
MYHRTEG_1.pdb	UNCLEAVED
LWDAVEG_2.pdb	UNCLEAVED
ESPRWEG_2.pdb	UNCLEAVED
VRCAGEG_1.pdb	UNCLEAVED
SSGWDEG_1.pdb	UNCLEAVED
ATGVTEG_4.pdb	UNCLEAVED
VLKACEG_1.pdb	UNCLEAVED
GMGWSEG_2.pdb	UNCLEAVED
DCTFSEG_0.pdb	UNCLEAVED
CVKALEG_4.pdb	UNCLEAVED
MWCGAEG_1.pdb	UNCLEAVED
FGHRVEG_1.pdb	UNCLEAVED
MSTVVEG_2.pdb	UNCLEAVED
VSADVEG_0.pdb	UNCLEAVED
WMCLREG_0.pdb	UNCLEAVED
IRSRSEG_2.pdb	UNCLEAVED
RCCWKEG_4.pdb	UNCLEAVED
RRGWVEG_1.pdb	UNCLEAVED
SEGYGEG_1.pdb	UNCLEAVED
YWWLVEG_0.pdb	UNCLEAVED
GKVRHEG_1.pdb	UNCLEAVED
VFGWPEG_4.pdb	UNCLEAVED
ANGWVEG_2.pdb	UNCLEAVED
EMSPVEG_4.pdb	UNCLEAVED
CARGGEG_3.pdb	UNCLEAVED
TGYCLEG_3.pdb	UNCLEAVED
TLVVGEG_4.pdb	UNCLEAVED
QMKRIEG_0.pdb	UNCLEAVED
VWCYGEG_3.pdb	UNCLEAVED
VREGVEG_1.pdb	UNCLEAVED
FVGGVEG_3.pdb	UNCLEAVED
WIVVGEG_1.pdb	UNCLEAVED
MMRCSEG_1.pdb	UNCLEAVED
GAGLVEG_0.pdb	UNCLEAVED
LVGSEEG_1.pdb	UNCLEAVED
TVGWIEG_3.pdb	UNCLEAVED
LVGSVEG_3.pdb	UNCLEAVED
ICGVSEG_2.pdb	UNCLEAVED
YWGRVEG_0.pdb	UNCLEAVED
FGECREG_1.pdb	UNCLEAVED
MIRAAEG_3.pdb	UNCLEAVED
KFTWTEG_4.pdb	UNCLEAVED
CVIGTEG_2.pdb	UNCLEAVED
LVYGREG_3.pdb	UNCLEAVED
CPRVGEG_1.pdb	UNCLEAVED
AMVVVEG_3.pdb	UNCLEAVED
CIVVVEG_1.pdb	UNCLEAVED
KLGWPEG_0.pdb	UNCLEAVED
GRQEIEG_4.pdb	UNCLEAVED
QKHRIEG_1.pdb	UNCLEAVED
NMVVTEG_3.pdb	UNCLEAVED
VLWQAEG_2.pdb	UNCLEAVED
GMSSSEG_3.pdb	UNCLEAVED
WVCVGEG_1.pdb	UNCLEAVED
VKCAVEG_0.pdb	UNCLEAVED
HCFVVEG_0.pdb	UNCLEAVED
LSRCIEG_3.pdb	UNCLEAVED
IDAGIEG_4.pdb	UNCLEAVED
VWCRGEG_3.pdb	UNCLEAVED
CCGRCEG_2.pdb	UNCLEAVED
CVGVTEG_0.pdb	UNCLEAVED
QLDVEEG_4.pdb	UNCLEAVED
DTDVNEG_3.pdb	UNCLEAVED
VWGVAEG_2.pdb	UNCLEAVED
GRGYVEG_2.pdb	UNCLEAVED
NQKLREG_4.pdb	UNCLEAVED
LCPGEEG_2.pdb	UNCLEAVED
MALCSEG_4.pdb	UNCLEAVED
SFGRCEG_4.pdb	UNCLEAVED
SHCSNEG_2.pdb	UNCLEAVED
LDGVSEG_3.pdb	UNCLEAVED
GSSWVEG_3.pdb	UNCLEAVED
IGVDGEG_4.pdb	UNCLEAVED
IRTCHEG_2.pdb	UNCLEAVED
VMGHVEG_3.pdb	UNCLEAVED
CGLVHEG_0.pdb	UNCLEAVED
WRTGQEG_1.pdb	UNCLEAVED
GNTCREG_3.pdb	UNCLEAVED
CPVLSEG_2.pdb	UNCLEAVED
WVLRVEG_2.pdb	UNCLEAVED
CWSTPEG_0.pdb	UNCLEAVED
CGLLSEG_4.pdb	UNCLEAVED
RQARIEG_1.pdb	UNCLEAVED
LFSGCEG_1.pdb	UNCLEAVED
WVVHPEG_1.pdb	UNCLEAVED
CRQLREG_3.pdb	UNCLEAVED
GKRKVEG_4.pdb	UNCLEAVED
GLGVGEG_1.pdb	UNCLEAVED
YLGSVEG_0.pdb	UNCLEAVED
GAPCFEG_0.pdb	UNCLEAVED
MLVVVEG_4.pdb	UNCLEAVED
CAVCIEG_4.pdb	UNCLEAVED
WLAGTEG_3.pdb	UNCLEAVED
GVCAHEG_4.pdb	UNCLEAVED
SDVVSEG_3.pdb	UNCLEAVED
LGSQTEG_0.pdb	UNCLEAVED
SSDGSEG_0.pdb	UNCLEAVED
PCSCTEG_4.pdb	UNCLEAVED
CQPGCEG_2.pdb	UNCLEAVED
GLTTVEG_0.pdb	UNCLEAVED
GVSCREG_1.pdb	UNCLEAVED
GTGRGEG_0.pdb	UNCLEAVED
RLMGHEG_4.pdb	UNCLEAVED
SYFRSEG_3.pdb	UNCLEAVED
LKTYGEG_3.pdb	UNCLEAVED
RCVNEEG_0.pdb	UNCLEAVED
VSWITEG_0.pdb	UNCLEAVED
FAHSNEG_1.pdb	UNCLEAVED
ENIWDEG_1.pdb	UNCLEAVED
EYMHSEG_0.pdb	UNCLEAVED
AFSACEG_4.pdb	UNCLEAVED
WWGIEEG_3.pdb	UNCLEAVED
RWVCVEG_0.pdb	UNCLEAVED
RGLMTEG_2.pdb	UNCLEAVED
RGYWREG_1.pdb	UNCLEAVED
ETCALEG_0.pdb	UNCLEAVED
VFTFGEG_2.pdb	UNCLEAVED
DGYCDEG_4.pdb	UNCLEAVED
SFMGAEG_1.pdb	UNCLEAVED
VVSQTEG_0.pdb	UNCLEAVED
VTHCQEG_0.pdb	UNCLEAVED
YMSVSEG_4.pdb	UNCLEAVED
YIAVTEG_1.pdb	UNCLEAVED
QRYRIEG_2.pdb	UNCLEAVED
RYCTREG_4.pdb	UNCLEAVED
CSMRVEG_2.pdb	UNCLEAVED
VVVVHEG_1.pdb	UNCLEAVED
DFVFTEG_1.pdb	UNCLEAVED
VLAKAEG_2.pdb	UNCLEAVED
FLGVSEG_0.pdb	UNCLEAVED
AIEAVEG_0.pdb	UNCLEAVED
IVGLGEG_2.pdb	UNCLEAVED
PGPAKEG_2.pdb	UNCLEAVED
LLGMGEG_3.pdb	UNCLEAVED
WNTGVEG_4.pdb	UNCLEAVED
PFVAVEG_3.pdb	UNCLEAVED
ILCQVEG_1.pdb	UNCLEAVED
LSWVGEG_1.pdb	UNCLEAVED
VLVCLEG_4.pdb	UNCLEAVED
RDGIIEG_2.pdb	UNCLEAVED
SFAGEEG_2.pdb	UNCLEAVED
LVGVVEG_4.pdb	UNCLEAVED
EQEQSEG_4.pdb	UNCLEAVED
MMYGIEG_4.pdb	UNCLEAVED
PLCDNEG_1.pdb	UNCLEAVED
SCVPGEG_3.pdb	UNCLEAVED
VYGLVEG_3.pdb	UNCLEAVED
APVRCEG_3.pdb	UNCLEAVED
NTGRWEG_0.pdb	UNCLEAVED
CGVPLEG_1.pdb	UNCLEAVED
SWGCAEG_2.pdb	UNCLEAVED
LWPTQEG_3.pdb	UNCLEAVED
IVRQREG_4.pdb	UNCLEAVED
LKKVKEG_0.pdb	UNCLEAVED
LCFGREG_0.pdb	UNCLEAVED
VGIEVEG_3.pdb	UNCLEAVED
PGTSVEG_0.pdb	UNCLEAVED
CVVPSEG_0.pdb	UNCLEAVED
RRAHVEG_1.pdb	UNCLEAVED
VDRIHEG_3.pdb	UNCLEAVED
MMSGHEG_1.pdb	UNCLEAVED
FVDGGEG_4.pdb	UNCLEAVED
YFLGCEG_3.pdb	UNCLEAVED
GWCVDEG_4.pdb	UNCLEAVED
SVRCVEG_0.pdb	UNCLEAVED
NVGCGEG_4.pdb	UNCLEAVED
RYWQIEG_1.pdb	UNCLEAVED
NHRMSEG_2.pdb	UNCLEAVED
RSVCREG_3.pdb	UNCLEAVED
PPGMDEG_3.pdb	UNCLEAVED
VSNGYEG_2.pdb	UNCLEAVED
KIGLKEG_4.pdb	UNCLEAVED
AGVALEG_3.pdb	UNCLEAVED
CGIQAEG_1.pdb	UNCLEAVED
SAFSTEG_3.pdb	UNCLEAVED
YALLGEG_1.pdb	UNCLEAVED
FRSVREG_1.pdb	UNCLEAVED
FRPLDEG_4.pdb	UNCLEAVED
FASRCEG_1.pdb	UNCLEAVED
VLLRYEG_4.pdb	UNCLEAVED
RFGVVEG_4.pdb	UNCLEAVED
CDRSCEG_0.pdb	UNCLEAVED
LVLIREG_2.pdb	UNCLEAVED
FHVSAEG_3.pdb	UNCLEAVED
LTIGTEG_3.pdb	UNCLEAVED
VISGKEG_0.pdb	UNCLEAVED
IWLDVEG_2.pdb	UNCLEAVED
PEGVVEG_4.pdb	UNCLEAVED
EIIGKEG_0.pdb	UNCLEAVED
HLQADEG_2.pdb	UNCLEAVED
WTVGGEG_3.pdb	UNCLEAVED
RYSRMEG_2.pdb	UNCLEAVED
WYGTAEG_1.pdb	UNCLEAVED
VNACVEG_1.pdb	UNCLEAVED
MVVAVEG_3.pdb	UNCLEAVED
IRGHSEG_3.pdb	UNCLEAVED
RCTSIEG_3.pdb	UNCLEAVED
RFFMSEG_2.pdb	UNCLEAVED
GRLLEEG_2.pdb	UNCLEAVED
TRRVVEG_4.pdb	UNCLEAVED
GVEFSEG_0.pdb	UNCLEAVED
ACGVSEG_2.pdb	UNCLEAVED
SSGLVEG_1.pdb	UNCLEAVED
GYGLVEG_3.pdb	UNCLEAVED
ERVVREG_1.pdb	UNCLEAVED
IRGDIEG_3.pdb	UNCLEAVED
YDSRSEG_0.pdb	UNCLEAVED
AVEFDEG_4.pdb	UNCLEAVED
CAPVCEG_2.pdb	UNCLEAVED
YTFVREG_0.pdb	UNCLEAVED
CHVVKEG_2.pdb	UNCLEAVED
RMGGSEG_4.pdb	UNCLEAVED
GRKWREG_4.pdb	UNCLEAVED
CEVMGEG_0.pdb	UNCLEAVED
YVGRIEG_3.pdb	UNCLEAVED
DGVLAEG_4.pdb	UNCLEAVED
FLNREEG_1.pdb	UNCLEAVED
KVPFSEG_0.pdb	UNCLEAVED
LYYDGEG_1.pdb	UNCLEAVED
IQETVEG_2.pdb	UNCLEAVED
RFNRAEG_3.pdb	UNCLEAVED
SRDVVEG_0.pdb	UNCLEAVED
KGEFGEG_2.pdb	UNCLEAVED
WGAWDEG_1.pdb	UNCLEAVED
SDTGVEG_0.pdb	UNCLEAVED
LLRAAEG_0.pdb	UNCLEAVED
TGRAYEG_1.pdb	UNCLEAVED
GYVVREG_2.pdb	UNCLEAVED
AVVVAEG_0.pdb	UNCLEAVED
RCSLDEG_2.pdb	UNCLEAVED
SVVLVEG_2.pdb	UNCLEAVED
VAGVAEG_4.pdb	UNCLEAVED
SQWCTEG_2.pdb	UNCLEAVED
GCRGWEG_4.pdb	UNCLEAVED
AWCAGEG_4.pdb	UNCLEAVED
WGGVGEG_1.pdb	UNCLEAVED
SIRGIEG_1.pdb	UNCLEAVED
PVGGTEG_0.pdb	UNCLEAVED
GGGWPEG_4.pdb	UNCLEAVED
WARFVEG_2.pdb	UNCLEAVED
GVHVREG_1.pdb	UNCLEAVED
FSPSLEG_3.pdb	UNCLEAVED
SIPRSEG_3.pdb	UNCLEAVED
IDFPVEG_3.pdb	UNCLEAVED
DNVVEEG_1.pdb	UNCLEAVED
FGVEGEG_4.pdb	UNCLEAVED
CLRRWEG_1.pdb	UNCLEAVED
CSLEREG_1.pdb	UNCLEAVED
GSQVVEG_4.pdb	UNCLEAVED
DCYSVEG_3.pdb	UNCLEAVED
EWAYGEG_4.pdb	UNCLEAVED
LAGAAEG_4.pdb	UNCLEAVED
FVVLSEG_0.pdb	UNCLEAVED
GAVDGEG_2.pdb	UNCLEAVED
YDTTDEG_1.pdb	UNCLEAVED
YKVRGEG_1.pdb	UNCLEAVED
VLRVGEG_3.pdb	UNCLEAVED
LLCVIEG_2.pdb	UNCLEAVED
SLCGMEG_2.pdb	UNCLEAVED
CRGIREG_2.pdb	UNCLEAVED
EYGGGEG_0.pdb	UNCLEAVED
FITAVEG_1.pdb	UNCLEAVED
YSGSTEG_4.pdb	UNCLEAVED
NAVVVEG_1.pdb	UNCLEAVED
SAGGMEG_0.pdb	UNCLEAVED
RVDGCEG_4.pdb	UNCLEAVED
DLWRVEG_4.pdb	UNCLEAVED
RVLRSEG_4.pdb	UNCLEAVED
VFGSREG_3.pdb	UNCLEAVED
FGEKIEG_1.pdb	UNCLEAVED
GLVVEEG_1.pdb	UNCLEAVED
GRVCIEG_1.pdb	UNCLEAVED
RRYRVEG_3.pdb	UNCLEAVED
DRRTVEG_3.pdb	UNCLEAVED
NCTLVEG_3.pdb	UNCLEAVED
EGRCPEG_4.pdb	UNCLEAVED
CESGIEG_0.pdb	UNCLEAVED
LPLPSEG_1.pdb	UNCLEAVED
TGGSAEG_1.pdb	UNCLEAVED
WGRGCEG_2.pdb	UNCLEAVED
FCREGEG_2.pdb	UNCLEAVED
IQSRREG_2.pdb	UNCLEAVED
CGLLGEG_3.pdb	UNCLEAVED
FRSTTEG_2.pdb	UNCLEAVED
VQVGIEG_3.pdb	UNCLEAVED
VAYVGEG_4.pdb	UNCLEAVED
GFVWSEG_4.pdb	UNCLEAVED
VISVAEG_1.pdb	UNCLEAVED
PKSCSEG_2.pdb	UNCLEAVED
SGVDVEG_2.pdb	UNCLEAVED
VGSSAEG_1.pdb	UNCLEAVED
YCVDSEG_0.pdb	UNCLEAVED
LVGDVEG_0.pdb	UNCLEAVED
ECVRSEG_2.pdb	UNCLEAVED
RKGHREG_3.pdb	UNCLEAVED
VFGIVEG_3.pdb	UNCLEAVED
VGRQAEG_3.pdb	UNCLEAVED
VLLAIEG_3.pdb	UNCLEAVED
CRKWPEG_2.pdb	UNCLEAVED
GFSLSEG_0.pdb	UNCLEAVED
NNWFDEG_0.pdb	UNCLEAVED
YGGSWEG_4.pdb	UNCLEAVED
AAWVSEG_4.pdb	UNCLEAVED
MLDGNEG_2.pdb	UNCLEAVED
RNGASEG_2.pdb	UNCLEAVED
DLLGGEG_4.pdb	UNCLEAVED
YLVGSEG_1.pdb	UNCLEAVED
QGIGTEG_4.pdb	UNCLEAVED
GDCLVEG_3.pdb	UNCLEAVED
LCVHTEG_0.pdb	UNCLEAVED
EFGEGEG_1.pdb	UNCLEAVED
NGGQAEG_4.pdb	UNCLEAVED
RLLGVEG_3.pdb	UNCLEAVED
VRGVQEG_4.pdb	UNCLEAVED
CLLNGEG_4.pdb	UNCLEAVED
YGCVIEG_4.pdb	UNCLEAVED
WAGDSEG_4.pdb	UNCLEAVED
CHGRSEG_2.pdb	UNCLEAVED
EVMIHEG_0.pdb	UNCLEAVED
HLFLSEG_1.pdb	UNCLEAVED
VVGRWEG_0.pdb	UNCLEAVED
QVVVEEG_1.pdb	UNCLEAVED
IMIATEG_3.pdb	UNCLEAVED
RYLDREG_2.pdb	UNCLEAVED
GDMQAEG_2.pdb	UNCLEAVED
RQRCREG_2.pdb	UNCLEAVED
CHFSTEG_0.pdb	UNCLEAVED
GTMVEEG_4.pdb	UNCLEAVED
GNGPREG_0.pdb	UNCLEAVED
GLCAPEG_1.pdb	UNCLEAVED
GRLGNEG_4.pdb	UNCLEAVED
LGLGVEG_2.pdb	UNCLEAVED
VAGVEEG_0.pdb	UNCLEAVED
GLVLGEG_4.pdb	UNCLEAVED
GQRRSEG_3.pdb	UNCLEAVED
NCLANEG_0.pdb	UNCLEAVED
YGRICEG_1.pdb	UNCLEAVED
NYLVNEG_4.pdb	UNCLEAVED
IISRVEG_4.pdb	UNCLEAVED
WCVVREG_3.pdb	UNCLEAVED
CFNMGEG_2.pdb	UNCLEAVED
VCSRVEG_0.pdb	UNCLEAVED
NSFTIEG_3.pdb	UNCLEAVED
SIRGSEG_3.pdb	UNCLEAVED
FGWGGEG_4.pdb	UNCLEAVED
VAGLDEG_3.pdb	UNCLEAVED
GKDVVEG_3.pdb	UNCLEAVED
GCSRCEG_3.pdb	UNCLEAVED
ASCLKEG_4.pdb	UNCLEAVED
CCTSPEG_0.pdb	UNCLEAVED
NAYGNEG_1.pdb	UNCLEAVED
CRNISEG_2.pdb	UNCLEAVED
CVGGVEG_1.pdb	UNCLEAVED
VSWVGEG_0.pdb	UNCLEAVED
YMNSVEG_2.pdb	UNCLEAVED
QAACTEG_4.pdb	UNCLEAVED
CVGPGEG_4.pdb	UNCLEAVED
LGSACEG_2.pdb	UNCLEAVED
GRVRTEG_4.pdb	UNCLEAVED
KFGIREG_3.pdb	UNCLEAVED
LGGKSEG_4.pdb	UNCLEAVED
GVTTVEG_4.pdb	UNCLEAVED
GIRVVEG_3.pdb	UNCLEAVED
YCRSVEG_1.pdb	UNCLEAVED
LVGGVEG_0.pdb	UNCLEAVED
RFTGGEG_3.pdb	UNCLEAVED
DTICVEG_1.pdb	UNCLEAVED
GVPLVEG_3.pdb	UNCLEAVED
CLSFKEG_2.pdb	UNCLEAVED
WVADSEG_2.pdb	UNCLEAVED
VCWAGEG_3.pdb	UNCLEAVED
RCMKVEG_1.pdb	UNCLEAVED
VVTVNEG_3.pdb	UNCLEAVED
SQTSTEG_3.pdb	UNCLEAVED
VNLVREG_0.pdb	UNCLEAVED
LFTIFEG_0.pdb	UNCLEAVED
FHREGEG_0.pdb	UNCLEAVED
YDKGGEG_4.pdb	UNCLEAVED
SWGFSEG_1.pdb	UNCLEAVED
VQTCPEG_1.pdb	UNCLEAVED
CSYIVEG_2.pdb	UNCLEAVED
GLLWGEG_2.pdb	UNCLEAVED
CLGSVEG_4.pdb	UNCLEAVED
RLGGPEG_4.pdb	UNCLEAVED
LWTEGEG_3.pdb	UNCLEAVED
CVYAGEG_4.pdb	UNCLEAVED
QLFVQEG_0.pdb	UNCLEAVED
PLLSDEG_2.pdb	UNCLEAVED
LMFDGEG_4.pdb	UNCLEAVED
SGQVGEG_3.pdb	UNCLEAVED
FRMDYEG_2.pdb	UNCLEAVED
SWCVCEG_3.pdb	UNCLEAVED
CHTKMEG_0.pdb	UNCLEAVED
NFYMPEG_0.pdb	UNCLEAVED
SGGRHEG_2.pdb	UNCLEAVED
CNPSGEG_3.pdb	UNCLEAVED
SMYVREG_0.pdb	UNCLEAVED
RIGCVEG_4.pdb	UNCLEAVED
YGSVVEG_1.pdb	UNCLEAVED
SFNVCEG_0.pdb	UNCLEAVED
VGVVAEG_3.pdb	UNCLEAVED
CECCTEG_0.pdb	UNCLEAVED
VDLVEEG_0.pdb	UNCLEAVED
SLYAVEG_4.pdb	UNCLEAVED
SSLHVEG_3.pdb	UNCLEAVED
RDYRSEG_3.pdb	UNCLEAVED
RQYMSEG_1.pdb	UNCLEAVED
DKHLDEG_4.pdb	UNCLEAVED
MMCVSEG_3.pdb	UNCLEAVED
LGGDSEG_0.pdb	UNCLEAVED
CDVIREG_3.pdb	UNCLEAVED
YGHHREG_4.pdb	UNCLEAVED
WAQRIEG_2.pdb	UNCLEAVED
YAYPVEG_3.pdb	UNCLEAVED
LRGSVEG_2.pdb	UNCLEAVED
LSFIAEG_3.pdb	UNCLEAVED
MVPCCEG_0.pdb	UNCLEAVED
VSGCSEG_2.pdb	UNCLEAVED
VGWPHEG_4.pdb	UNCLEAVED
ALVDSEG_4.pdb	UNCLEAVED
CPFNIEG_2.pdb	UNCLEAVED
YWVSREG_4.pdb	UNCLEAVED
MVEHSEG_4.pdb	UNCLEAVED
CLVVKEG_3.pdb	UNCLEAVED
STCGSEG_0.pdb	UNCLEAVED
VQVLGEG_2.pdb	UNCLEAVED
GRFSGEG_3.pdb	UNCLEAVED
NRLWKEG_2.pdb	UNCLEAVED
FTSVVEG_4.pdb	UNCLEAVED
LHLSKEG_4.pdb	UNCLEAVED
MLCRVEG_0.pdb	UNCLEAVED
CTVSREG_1.pdb	UNCLEAVED
CLSRSEG_2.pdb	UNCLEAVED
FTGVNEG_4.pdb	UNCLEAVED
LVTGCEG_2.pdb	UNCLEAVED
