Sequence	Result
GSMGVQA_0.pdb	CLEAVED
HCLNHQA_0.pdb	CLEAVED
CYIRHQA_4.pdb	CLEAVED
LHKKLQA_2.pdb	CLEAVED
LTRRLQA_1.pdb	CLEAVED
LMLTYQA_3.pdb	CLEAVED
QVEDGQA_4.pdb	CLEAVED
FRRAGQA_3.pdb	CLEAVED
CWSLDQA_0.pdb	CLEAVED
SIGNSQA_3.pdb	CLEAVED
NFTCFQA_0.pdb	CLEAVED
VAIKYQA_3.pdb	CLEAVED
LIKKDQA_3.pdb	CLEAVED
AGIWSQA_2.pdb	CLEAVED
LCVVFQA_3.pdb	CLEAVED
KYRSMQA_0.pdb	CLEAVED
RRNALQA_1.pdb	CLEAVED
FGVIYQA_4.pdb	CLEAVED
SLRRRQA_0.pdb	CLEAVED
WLWPRQA_4.pdb	CLEAVED
RLMTEQA_1.pdb	CLEAVED
ILCLYQA_4.pdb	CLEAVED
VLTHYQA_4.pdb	CLEAVED
HSVQYQA_3.pdb	CLEAVED
ASPVGQA_4.pdb	CLEAVED
GDCMSQA_0.pdb	CLEAVED
SPMVLQA_2.pdb	CLEAVED
CILRYQA_4.pdb	CLEAVED
QRTWYQA_1.pdb	CLEAVED
QMGLNQA_4.pdb	CLEAVED
HMVVRQA_1.pdb	CLEAVED
PEPRTQA_4.pdb	CLEAVED
CVFGVQA_1.pdb	CLEAVED
WKNSEQA_0.pdb	CLEAVED
HCGLEQA_1.pdb	CLEAVED
HYWSRQA_3.pdb	CLEAVED
EWTPQQA_3.pdb	CLEAVED
FVFYWQA_1.pdb	CLEAVED
GTVVCQA_0.pdb	CLEAVED
ILTLYQA_1.pdb	CLEAVED
NHVKRQA_0.pdb	CLEAVED
SLSLIQA_4.pdb	CLEAVED
GNVIFQA_3.pdb	CLEAVED
RKLIYQA_0.pdb	CLEAVED
TWCCSQA_3.pdb	CLEAVED
YSSRCQA_1.pdb	CLEAVED
GKTVFQA_1.pdb	CLEAVED
KLSMCQA_1.pdb	CLEAVED
VYKRGQA_2.pdb	CLEAVED
STVKHQA_3.pdb	CLEAVED
SFLKYQA_2.pdb	CLEAVED
WGLHFQA_2.pdb	CLEAVED
PQVIYQA_2.pdb	CLEAVED
CITNWQA_1.pdb	CLEAVED
QMDRVQA_4.pdb	CLEAVED
YQAFGQA_1.pdb	CLEAVED
FAKREQA_2.pdb	CLEAVED
RHFRRQA_4.pdb	CLEAVED
IVKWFQA_1.pdb	CLEAVED
FTTQTQA_2.pdb	CLEAVED
NRVRYQA_2.pdb	CLEAVED
SLITYQA_0.pdb	CLEAVED
NCEWMQA_1.pdb	CLEAVED
SRLTYQA_2.pdb	CLEAVED
SRFVSQA_2.pdb	CLEAVED
RDVLYQA_2.pdb	CLEAVED
HKLRYQA_1.pdb	CLEAVED
RYCTFQA_2.pdb	CLEAVED
NFDKWQA_4.pdb	CLEAVED
CIRNAQA_0.pdb	CLEAVED
PLILLQA_4.pdb	CLEAVED
VGVSVQA_4.pdb	CLEAVED
NDLILQA_4.pdb	CLEAVED
LERLKQA_4.pdb	CLEAVED
RLVRYQA_0.pdb	CLEAVED
TCVCTQA_4.pdb	CLEAVED
WDDTIQA_4.pdb	CLEAVED
RMVAYQA_1.pdb	CLEAVED
DKRCLQA_1.pdb	CLEAVED
HGSNKQA_0.pdb	CLEAVED
NLTRRQA_4.pdb	CLEAVED
SQVLYQA_1.pdb	CLEAVED
VCRFVQA_2.pdb	CLEAVED
MLVAWQA_1.pdb	CLEAVED
VRGRYQA_2.pdb	CLEAVED
MHSQPQA_2.pdb	CLEAVED
LFGRRQA_3.pdb	CLEAVED
LRDITQA_2.pdb	CLEAVED
PAKRVQA_1.pdb	CLEAVED
RFVLHQA_2.pdb	CLEAVED
PLYRRQA_0.pdb	CLEAVED
DKRAAQA_0.pdb	CLEAVED
RVDMFQA_2.pdb	CLEAVED
SAFENQA_2.pdb	CLEAVED
NMVVFQA_1.pdb	CLEAVED
DVYIYQA_2.pdb	CLEAVED
QLVERQA_2.pdb	CLEAVED
RGTSFQA_4.pdb	CLEAVED
VVRKRQA_3.pdb	CLEAVED
LKWVSQA_2.pdb	CLEAVED
HCGTVQA_2.pdb	CLEAVED
SAVQEQA_1.pdb	CLEAVED
GMNYIQA_4.pdb	CLEAVED
EKLAWQA_2.pdb	CLEAVED
RLYPHQA_3.pdb	CLEAVED
RTLGVQA_1.pdb	CLEAVED
LRLSHQA_3.pdb	CLEAVED
FLVAFQA_3.pdb	CLEAVED
QKNISQA_4.pdb	CLEAVED
GQFRRQA_3.pdb	CLEAVED
SSAVTQA_1.pdb	CLEAVED
RLARQQA_4.pdb	CLEAVED
AVFRRQA_0.pdb	CLEAVED
EVWSDQA_1.pdb	CLEAVED
SSVMWQA_3.pdb	CLEAVED
MTLMYQA_4.pdb	CLEAVED
HVVLYQA_3.pdb	CLEAVED
MLGRFQA_3.pdb	CLEAVED
AFLDYQA_4.pdb	CLEAVED
SYMYYQA_4.pdb	CLEAVED
FLPRYQA_2.pdb	CLEAVED
RGVLYQA_0.pdb	CLEAVED
YRVQFQA_2.pdb	CLEAVED
FYLEFQA_2.pdb	CLEAVED
KPVRYQA_3.pdb	CLEAVED
IGLAWQA_0.pdb	CLEAVED
ITLMYQA_0.pdb	CLEAVED
KIKREQA_4.pdb	CLEAVED
GLRIRQA_3.pdb	CLEAVED
LNTGHQA_0.pdb	CLEAVED
SDWIRQA_2.pdb	CLEAVED
PQVQWQA_4.pdb	CLEAVED
VGGYLQA_0.pdb	CLEAVED
LCFQCQA_2.pdb	CLEAVED
YCVVWQA_1.pdb	CLEAVED
WLTGNQA_3.pdb	CLEAVED
LLRARQA_1.pdb	CLEAVED
SKVRWQA_0.pdb	CLEAVED
FGNACQA_3.pdb	CLEAVED
YLCSYQA_4.pdb	CLEAVED
SRVCYQA_1.pdb	CLEAVED
TRHRLQA_0.pdb	CLEAVED
VKAWYQA_3.pdb	CLEAVED
LMERSQA_1.pdb	CLEAVED
LAKREQA_0.pdb	CLEAVED
MYVRYQA_0.pdb	CLEAVED
DWVKWQA_4.pdb	CLEAVED
ERVCHQA_2.pdb	CLEAVED
CTVAFQA_0.pdb	CLEAVED
MKKRRQA_2.pdb	CLEAVED
WLAAFQA_2.pdb	CLEAVED
YRCIRQA_4.pdb	CLEAVED
TCVVYQA_3.pdb	CLEAVED
VIAKYQA_3.pdb	CLEAVED
WDCSPQA_0.pdb	CLEAVED
KVILWQA_0.pdb	CLEAVED
VKRDYQA_4.pdb	CLEAVED
QRVKHQA_2.pdb	CLEAVED
TEMYQQA_2.pdb	CLEAVED
LQVRGQA_1.pdb	CLEAVED
GLVIWQA_4.pdb	CLEAVED
SVVVWQA_1.pdb	CLEAVED
VVFQVQA_2.pdb	CLEAVED
RLVRRQA_2.pdb	CLEAVED
KRRMVQA_0.pdb	CLEAVED
SFCRFQA_4.pdb	CLEAVED
VSSSIQA_3.pdb	CLEAVED
LPVKRQA_1.pdb	CLEAVED
VLCSYQA_2.pdb	CLEAVED
HLLVRQA_1.pdb	CLEAVED
DGVLWQA_4.pdb	CLEAVED
ILCRYQA_1.pdb	CLEAVED
QRGSSQA_3.pdb	CLEAVED
SLSMMQA_3.pdb	CLEAVED
RRVRFQA_0.pdb	CLEAVED
LYAKYQA_0.pdb	CLEAVED
PCVMFQA_1.pdb	CLEAVED
VKLRRQA_4.pdb	CLEAVED
MKCMFQA_0.pdb	CLEAVED
NPVLFQA_4.pdb	CLEAVED
KSTVYQA_4.pdb	CLEAVED
LQKRNQA_0.pdb	CLEAVED
ARVRYQA_0.pdb	CLEAVED
KMVRYQA_1.pdb	CLEAVED
KAVKYQA_4.pdb	CLEAVED
SFMVRQA_3.pdb	CLEAVED
YMKGIQA_1.pdb	CLEAVED
LRARFQA_4.pdb	CLEAVED
CKFEEQA_4.pdb	CLEAVED
HVSHEQA_3.pdb	CLEAVED
RYFPDQA_3.pdb	CLEAVED
AFHSRQA_0.pdb	CLEAVED
LLTTCQA_4.pdb	CLEAVED
SELHAQA_4.pdb	CLEAVED
CRKCMQA_0.pdb	CLEAVED
HSRNEQA_2.pdb	CLEAVED
KHESHQA_0.pdb	CLEAVED
RFEEWQA_3.pdb	CLEAVED
RREYVQA_3.pdb	CLEAVED
NVFSCQA_0.pdb	CLEAVED
QRTHEQA_0.pdb	CLEAVED
ETCSCQA_1.pdb	CLEAVED
MTVFSQA_2.pdb	CLEAVED
AGKTSQA_3.pdb	CLEAVED
MYFRGQA_1.pdb	CLEAVED
WREKNQA_4.pdb	CLEAVED
RSAGKQA_0.pdb	CLEAVED
PGHVKQA_4.pdb	CLEAVED
FTNLCQA_1.pdb	CLEAVED
SICLAQA_4.pdb	CLEAVED
VVKGCQA_3.pdb	CLEAVED
RVSERQA_3.pdb	CLEAVED
GFPCWQA_2.pdb	CLEAVED
LPTQSQA_3.pdb	CLEAVED
MFKRLQA_0.pdb	CLEAVED
RTNSEQA_3.pdb	CLEAVED
TYCRLQA_1.pdb	CLEAVED
SVWPTQA_0.pdb	CLEAVED
MRHPVQA_3.pdb	CLEAVED
SHALDQA_0.pdb	CLEAVED
MYFRCQA_4.pdb	CLEAVED
PPYMAQA_1.pdb	CLEAVED
WLTSWQA_0.pdb	CLEAVED
KFEVYQA_0.pdb	CLEAVED
TTCHSQA_4.pdb	CLEAVED
CWDMDQA_3.pdb	CLEAVED
YPQPDQA_4.pdb	CLEAVED
NRMNYQA_1.pdb	CLEAVED
SVIAIQA_0.pdb	CLEAVED
CSWTSQA_2.pdb	CLEAVED
YSRDTQA_0.pdb	CLEAVED
SLFEQQA_2.pdb	CLEAVED
LARFDQA_0.pdb	CLEAVED
PESGSQA_3.pdb	CLEAVED
MWCLSQA_0.pdb	CLEAVED
ASDRCQA_3.pdb	CLEAVED
SLVARQA_4.pdb	CLEAVED
INVSAQA_3.pdb	CLEAVED
AAIVRQA_2.pdb	CLEAVED
HGKAQQA_4.pdb	CLEAVED
VKLCGQA_4.pdb	CLEAVED
PFAMGQA_1.pdb	CLEAVED
FASRFQA_0.pdb	CLEAVED
SLSVCQA_3.pdb	CLEAVED
WLMDIQA_4.pdb	CLEAVED
FDLWSQA_0.pdb	CLEAVED
CFVVYQA_4.pdb	CLEAVED
YRYQAQA_3.pdb	CLEAVED
RVSSEQA_4.pdb	CLEAVED
SGRAYQA_0.pdb	CLEAVED
RSGKNQA_0.pdb	CLEAVED
NRVGAQA_1.pdb	CLEAVED
CVVYSQA_4.pdb	CLEAVED
TCGTGQA_3.pdb	CLEAVED
TLRSAQA_1.pdb	CLEAVED
FKARQQA_2.pdb	CLEAVED
SDTAGQA_2.pdb	CLEAVED
ANFLLQA_0.pdb	CLEAVED
MREVEQA_1.pdb	CLEAVED
NEVVVQA_2.pdb	CLEAVED
RLVARQA_0.pdb	CLEAVED
RQMMLQA_2.pdb	CLEAVED
DHSYRQA_1.pdb	CLEAVED
SILNCQA_2.pdb	CLEAVED
CNTVMQA_2.pdb	CLEAVED
CRKWFQA_4.pdb	CLEAVED
VLGRVQA_0.pdb	CLEAVED
KCVASQA_4.pdb	CLEAVED
YYVPYQA_4.pdb	CLEAVED
GRVVRQA_0.pdb	CLEAVED
AYSYAQA_1.pdb	CLEAVED
QRKVGQA_4.pdb	CLEAVED
VALLRQA_4.pdb	CLEAVED
TCRDIQA_4.pdb	CLEAVED
TGYGSQA_0.pdb	CLEAVED
LRTSAQA_0.pdb	CLEAVED
QLCAWQA_1.pdb	CLEAVED
KHRVEQA_4.pdb	CLEAVED
ISNDHQA_1.pdb	CLEAVED
VLGRQQA_1.pdb	CLEAVED
GSVCVQA_3.pdb	CLEAVED
HQSGKQA_2.pdb	CLEAVED
MRLTAQA_1.pdb	CLEAVED
KFVNSQA_1.pdb	CLEAVED
GLWIEQA_3.pdb	CLEAVED
RLIVWQA_0.pdb	CLEAVED
LHSCYQA_1.pdb	CLEAVED
RHWKFQA_0.pdb	CLEAVED
SCMTEQA_4.pdb	CLEAVED
FLRSLQA_2.pdb	CLEAVED
YVRSTQA_1.pdb	CLEAVED
PPSISQA_2.pdb	CLEAVED
QSGGRQA_2.pdb	CLEAVED
NNDLLQA_4.pdb	CLEAVED
MLRLHQA_0.pdb	CLEAVED
SSHPPQA_0.pdb	CLEAVED
IGCPGQA_1.pdb	CLEAVED
VRYRSQA_2.pdb	CLEAVED
STWMYQA_3.pdb	CLEAVED
HRSSAQA_4.pdb	CLEAVED
TAFAWQA_4.pdb	CLEAVED
CKMMKQA_4.pdb	CLEAVED
NSRTRQA_1.pdb	CLEAVED
LLLSFQA_1.pdb	CLEAVED
WRTARQA_3.pdb	CLEAVED
RWFGSQA_3.pdb	CLEAVED
IGLGCQA_4.pdb	CLEAVED
MPHPYQA_2.pdb	CLEAVED
EMIWYQA_2.pdb	CLEAVED
LMWFSQA_0.pdb	CLEAVED
THCRLQA_3.pdb	CLEAVED
TKPTEQA_1.pdb	CLEAVED
RTGVHQA_3.pdb	CLEAVED
PRATSQA_2.pdb	CLEAVED
FPVSMQA_4.pdb	CLEAVED
ECGRHQA_3.pdb	CLEAVED
WKASLQA_1.pdb	CLEAVED
IWGSVQA_3.pdb	CLEAVED
SGPGWQA_3.pdb	CLEAVED
YCVSRQA_1.pdb	CLEAVED
EKLTGQA_0.pdb	CLEAVED
AVMFRQA_0.pdb	CLEAVED
MFSICQA_1.pdb	CLEAVED
LDRTSQA_3.pdb	CLEAVED
GAETDQA_0.pdb	CLEAVED
FALTVQA_4.pdb	CLEAVED
MSSCYQA_1.pdb	CLEAVED
MIRMTQA_4.pdb	CLEAVED
TQWDRQA_4.pdb	CLEAVED
YLRNCQA_0.pdb	CLEAVED
WLKAWQA_4.pdb	CLEAVED
LCLRLQA_2.pdb	CLEAVED
RCRLIQA_4.pdb	CLEAVED
KAIRAQA_1.pdb	CLEAVED
PTWWYQA_0.pdb	CLEAVED
SGTHPQA_4.pdb	CLEAVED
DFLLNQA_4.pdb	CLEAVED
FELQWQA_2.pdb	CLEAVED
NRVRLQA_1.pdb	CLEAVED
CVRNEQA_3.pdb	CLEAVED
TIMGDQA_3.pdb	CLEAVED
WHLFSQA_4.pdb	CLEAVED
KDIHLQA_0.pdb	CLEAVED
VVKMSQA_4.pdb	CLEAVED
SEAITQA_2.pdb	CLEAVED
QASECQA_1.pdb	CLEAVED
TIMWRQA_1.pdb	CLEAVED
GDKFRQA_2.pdb	CLEAVED
KCGIRQA_1.pdb	CLEAVED
IDGKDQA_4.pdb	CLEAVED
TSTVLQA_2.pdb	CLEAVED
LNRLIQA_0.pdb	CLEAVED
GDTRTQA_0.pdb	CLEAVED
PFVASQA_1.pdb	CLEAVED
GVYYRQA_3.pdb	CLEAVED
CWSWHQA_0.pdb	CLEAVED
AASRHQA_2.pdb	CLEAVED
GGRTYQA_2.pdb	CLEAVED
WLMVFQA_0.pdb	CLEAVED
YRPSHQA_3.pdb	CLEAVED
MSLCNQA_0.pdb	CLEAVED
DVLVGQA_2.pdb	CLEAVED
QLTGSQA_3.pdb	CLEAVED
SPMKSQA_2.pdb	CLEAVED
CTGSCQA_4.pdb	CLEAVED
GAWTQQA_3.pdb	CLEAVED
RLTYFQA_1.pdb	CLEAVED
FDSPPQA_1.pdb	CLEAVED
NLFEKQA_1.pdb	CLEAVED
SQTVLQA_4.pdb	CLEAVED
HVVTCQA_2.pdb	CLEAVED
PGRPYQA_4.pdb	CLEAVED
EDFVWQA_1.pdb	CLEAVED
QLLGPQA_1.pdb	CLEAVED
ARGCRQA_1.pdb	CLEAVED
HDVMFQA_0.pdb	CLEAVED
FWSRLQA_2.pdb	CLEAVED
SSKATQA_3.pdb	CLEAVED
PHFDHQA_3.pdb	CLEAVED
MLIAQQA_2.pdb	CLEAVED
SHTGKQA_4.pdb	CLEAVED
NHIPYQA_2.pdb	CLEAVED
RRARVQA_0.pdb	CLEAVED
DYGMGQA_4.pdb	CLEAVED
GNGPYQA_1.pdb	CLEAVED
FPLWAQA_3.pdb	CLEAVED
QHVKHQA_4.pdb	CLEAVED
NPHRGQA_1.pdb	CLEAVED
MGTFLQA_1.pdb	CLEAVED
CSASTQA_3.pdb	CLEAVED
IAESCQA_1.pdb	CLEAVED
NFVPRQA_1.pdb	CLEAVED
GSSEKQA_1.pdb	CLEAVED
CLARTQA_3.pdb	CLEAVED
TERRWQA_2.pdb	CLEAVED
LALQYQA_1.pdb	CLEAVED
VRLTPQA_2.pdb	CLEAVED
SLQGSQA_4.pdb	CLEAVED
QRTGVQA_4.pdb	CLEAVED
KRMMWQA_4.pdb	CLEAVED
RPSLMQA_2.pdb	CLEAVED
CLALWQA_3.pdb	CLEAVED
ASVRWQA_2.pdb	CLEAVED
TRVWNQA_2.pdb	CLEAVED
SWFRHQA_1.pdb	CLEAVED
MVAYCQA_4.pdb	CLEAVED
ISSLTQA_2.pdb	CLEAVED
AMLTPQA_2.pdb	CLEAVED
HRCRFQA_0.pdb	CLEAVED
CGVSLQA_1.pdb	CLEAVED
GHPGQQA_1.pdb	CLEAVED
YLVRWQA_4.pdb	CLEAVED
DPGELQA_1.pdb	CLEAVED
ENLRFQA_2.pdb	CLEAVED
CPSWLQA_1.pdb	CLEAVED
TVDCGQA_4.pdb	CLEAVED
FGKRQQA_3.pdb	CLEAVED
RVLCSQA_2.pdb	CLEAVED
ATPLTQA_3.pdb	CLEAVED
VLGRRQA_0.pdb	CLEAVED
GRRGGQA_0.pdb	CLEAVED
PLCVYQA_4.pdb	CLEAVED
YVVDYQA_3.pdb	CLEAVED
ESNVNQA_0.pdb	CLEAVED
VIKIRQA_2.pdb	CLEAVED
KRNWAQA_4.pdb	CLEAVED
LVEYLQA_2.pdb	CLEAVED
IRVSWQA_4.pdb	CLEAVED
RIYDRQA_2.pdb	CLEAVED
LARLRQA_3.pdb	CLEAVED
MIDEHQA_0.pdb	CLEAVED
SLSHKQA_1.pdb	CLEAVED
NCKMYQA_1.pdb	CLEAVED
TLVSWQA_1.pdb	CLEAVED
LHWVYQA_2.pdb	CLEAVED
EMNKWQA_3.pdb	CLEAVED
PQMHQQA_0.pdb	CLEAVED
LRLSVQA_0.pdb	CLEAVED
TLRKGQA_4.pdb	CLEAVED
AINIRQA_2.pdb	CLEAVED
TLTDVQA_0.pdb	CLEAVED
TRRGAQA_1.pdb	CLEAVED
HAVLKQA_2.pdb	CLEAVED
ANGAYQA_4.pdb	CLEAVED
EMVMQQA_0.pdb	CLEAVED
AWLLRQA_0.pdb	CLEAVED
MCSKRQA_0.pdb	CLEAVED
NWVGVQA_1.pdb	CLEAVED
NGRCVQA_4.pdb	CLEAVED
INMTSQA_1.pdb	CLEAVED
SVRLMQA_2.pdb	CLEAVED
YPVRGQA_4.pdb	CLEAVED
PSADEQA_4.pdb	CLEAVED
NSHLHQA_2.pdb	CLEAVED
HVVLMQA_4.pdb	CLEAVED
PLWLCQA_4.pdb	CLEAVED
LLFPRQA_2.pdb	CLEAVED
SKAAYQA_2.pdb	CLEAVED
ETVRWQA_0.pdb	CLEAVED
ACVNVQA_0.pdb	CLEAVED
SNVYYQA_0.pdb	CLEAVED
TSKASQA_2.pdb	CLEAVED
PVVCFQA_3.pdb	CLEAVED
QIVAYQA_1.pdb	CLEAVED
RQSMVQA_1.pdb	CLEAVED
CRRWYQA_1.pdb	CLEAVED
LCTCRQA_3.pdb	CLEAVED
CPFAEQA_2.pdb	CLEAVED
MSTQKQA_2.pdb	CLEAVED
RVLLAQA_4.pdb	CLEAVED
QFVNYQA_1.pdb	CLEAVED
TRVCFQA_0.pdb	CLEAVED
ACAMVQA_0.pdb	CLEAVED
IFLLSQA_0.pdb	CLEAVED
RLVHHQA_3.pdb	CLEAVED
RRACYQA_3.pdb	CLEAVED
GYVLYQA_1.pdb	CLEAVED
CVCYWQA_0.pdb	CLEAVED
RIAMYQA_1.pdb	CLEAVED
NLVFFQA_2.pdb	CLEAVED
WDLTHQA_3.pdb	CLEAVED
VKSLYQA_0.pdb	CLEAVED
CPAGSQA_4.pdb	CLEAVED
VSYVLQA_1.pdb	CLEAVED
LGSFKQA_0.pdb	CLEAVED
LTIWYQA_1.pdb	CLEAVED
DACIWQA_3.pdb	CLEAVED
GRAFRQA_0.pdb	CLEAVED
VGSRKQA_1.pdb	CLEAVED
SLGASQA_2.pdb	CLEAVED
TILLIQA_0.pdb	CLEAVED
SLDIIQA_4.pdb	CLEAVED
LSTEKQA_3.pdb	CLEAVED
KTWTYQA_1.pdb	CLEAVED
YCTGPQA_0.pdb	CLEAVED
RRNMIQA_1.pdb	CLEAVED
TTVRHQA_2.pdb	CLEAVED
FRTNAQA_1.pdb	CLEAVED
EQLTHQA_2.pdb	CLEAVED
KYIPCQA_4.pdb	CLEAVED
ALDGTQA_3.pdb	CLEAVED
KGSFRQA_1.pdb	CLEAVED
LEVEFQA_0.pdb	CLEAVED
ASCNMQA_2.pdb	CLEAVED
LLILRQA_2.pdb	CLEAVED
VDTAVQA_1.pdb	CLEAVED
LLWPLQA_2.pdb	CLEAVED
HLRLDQA_3.pdb	CLEAVED
FGVRMQA_1.pdb	CLEAVED
VKRSDQA_0.pdb	CLEAVED
NHVRHQA_4.pdb	CLEAVED
HGVCHQA_4.pdb	CLEAVED
PVVYTQA_1.pdb	CLEAVED
YHLIHQA_2.pdb	CLEAVED
SLCFWQA_0.pdb	CLEAVED
QSVVFQA_1.pdb	CLEAVED
KRACWQA_4.pdb	CLEAVED
LKLWPQA_1.pdb	CLEAVED
HHISYQA_0.pdb	CLEAVED
VFCCWQA_2.pdb	CLEAVED
KMTLSQA_0.pdb	CLEAVED
HYVRFQA_2.pdb	CLEAVED
FVWLMQA_0.pdb	CLEAVED
KRCMYQA_2.pdb	CLEAVED
IPDKCQA_1.pdb	CLEAVED
SERVRQA_2.pdb	CLEAVED
DSHRMQA_3.pdb	CLEAVED
VSDHVQA_1.pdb	CLEAVED
EYSLCQA_4.pdb	CLEAVED
RSLLWQA_4.pdb	CLEAVED
VSVYGQA_3.pdb	CLEAVED
RRISRQA_1.pdb	CLEAVED
NQVGDQA_0.pdb	CLEAVED
PLCNYQA_0.pdb	CLEAVED
CQLRVQA_4.pdb	CLEAVED
TYVLFQA_4.pdb	CLEAVED
ICVTYQA_4.pdb	CLEAVED
WLKLYQA_3.pdb	CLEAVED
CDFGPQA_1.pdb	CLEAVED
NIFQRQA_3.pdb	CLEAVED
RTVDYQA_0.pdb	CLEAVED
RLSRYQA_2.pdb	CLEAVED
RLAGRQA_4.pdb	CLEAVED
TLLWDQA_1.pdb	CLEAVED
CPIGWQA_2.pdb	CLEAVED
STLVCQA_4.pdb	CLEAVED
EYCTYQA_3.pdb	CLEAVED
RTMSFQA_1.pdb	CLEAVED
WWAHPQA_2.pdb	CLEAVED
QAVRYQA_3.pdb	CLEAVED
PFVSWQA_3.pdb	CLEAVED
ATTMCQA_1.pdb	CLEAVED
IPVGYQA_4.pdb	CLEAVED
ARVTAQA_0.pdb	CLEAVED
SWVIWQA_2.pdb	CLEAVED
LVPAGQA_2.pdb	CLEAVED
SDVMLQA_0.pdb	CLEAVED
AVVEFQA_0.pdb	CLEAVED
VGNTKQA_2.pdb	CLEAVED
IEDRVQA_4.pdb	CLEAVED
CFGRYQA_0.pdb	CLEAVED
QVSMYQA_3.pdb	CLEAVED
SSCRFQA_2.pdb	CLEAVED
ITITLQA_4.pdb	CLEAVED
ALRGGQA_2.pdb	CLEAVED
IEAHHQA_1.pdb	CLEAVED
RLVWFQA_2.pdb	CLEAVED
NDSVPQA_1.pdb	CLEAVED
VCLDSQA_3.pdb	CLEAVED
YVRRWQA_1.pdb	CLEAVED
WFVTGQA_3.pdb	CLEAVED
FRATYQA_1.pdb	CLEAVED
NDVAYQA_4.pdb	CLEAVED
WTVACQA_2.pdb	CLEAVED
GVAMVQA_0.pdb	CLEAVED
TLSLEQA_2.pdb	CLEAVED
KFNHGQA_1.pdb	CLEAVED
TRRSHQA_0.pdb	CLEAVED
ALMVWQA_0.pdb	CLEAVED
YWREQQA_0.pdb	CLEAVED
KAVRHQA_2.pdb	CLEAVED
CLVAYQA_3.pdb	CLEAVED
RCFRVQA_4.pdb	CLEAVED
SYYLSQA_4.pdb	CLEAVED
KAVRCQA_1.pdb	CLEAVED
KHQHSQA_4.pdb	CLEAVED
HEGNRQA_3.pdb	CLEAVED
RNVLFQA_1.pdb	CLEAVED
TKGCRQA_2.pdb	CLEAVED
QYLPAQA_2.pdb	CLEAVED
ALGVHQA_4.pdb	CLEAVED
SLVRLQA_1.pdb	CLEAVED
RLDPNQA_0.pdb	CLEAVED
VAVRHQA_3.pdb	CLEAVED
VWRSTQA_0.pdb	CLEAVED
TSVGFQA_2.pdb	CLEAVED
TLVIPQA_4.pdb	CLEAVED
IVVAYQA_2.pdb	CLEAVED
FLTRWQA_1.pdb	CLEAVED
PCCSWQA_3.pdb	CLEAVED
YFACAQA_1.pdb	CLEAVED
LHVTHQA_4.pdb	CLEAVED
WRKYMQA_2.pdb	CLEAVED
YGAPSQA_1.pdb	CLEAVED
DHRSNQA_1.pdb	CLEAVED
TLCVYQA_0.pdb	CLEAVED
GMCRQQA_0.pdb	CLEAVED
SAWIVQA_2.pdb	CLEAVED
STVWYQA_0.pdb	CLEAVED
YWVRHQA_3.pdb	CLEAVED
DDVVYQA_3.pdb	CLEAVED
ENSGFQA_1.pdb	CLEAVED
YHCKFQA_2.pdb	CLEAVED
MYVSWQA_3.pdb	CLEAVED
DALGRQA_3.pdb	CLEAVED
HLIGRQA_2.pdb	CLEAVED
NAVGFQA_0.pdb	CLEAVED
CYVRFQA_1.pdb	CLEAVED
TCLALQA_3.pdb	CLEAVED
HGVYWQA_3.pdb	CLEAVED
NWIGLQA_0.pdb	CLEAVED
SVVAFQA_1.pdb	CLEAVED
VYCMYQA_1.pdb	CLEAVED
KVVRYQA_0.pdb	CLEAVED
VTVSYQA_3.pdb	CLEAVED
LMYQHQA_3.pdb	CLEAVED
KSANTQA_4.pdb	CLEAVED
KVQSMQA_3.pdb	CLEAVED
YRVSWQA_2.pdb	CLEAVED
KSSGGQA_0.pdb	CLEAVED
CRDESQA_2.pdb	CLEAVED
RPPGLQA_0.pdb	CLEAVED
PRITYQA_2.pdb	CLEAVED
VYVLFQA_1.pdb	CLEAVED
QRNVVQA_0.pdb	CLEAVED
SHCEYQA_4.pdb	CLEAVED
RYVHYQA_3.pdb	CLEAVED
DAEPVQA_1.pdb	CLEAVED
SLSPRQA_3.pdb	CLEAVED
LLCRWQA_1.pdb	CLEAVED
KCHNLQA_4.pdb	CLEAVED
AVAHSQA_1.pdb	CLEAVED
GFMSWQA_2.pdb	CLEAVED
QEVRCQA_0.pdb	CLEAVED
IPCAFQA_3.pdb	CLEAVED
RASAEQA_0.pdb	CLEAVED
LRPRYQA_4.pdb	CLEAVED
FHVRYQA_2.pdb	CLEAVED
RCVRYQA_0.pdb	CLEAVED
GWVQWQA_2.pdb	CLEAVED
CLPMQQA_1.pdb	CLEAVED
PWNASQA_2.pdb	CLEAVED
FLWCCQA_2.pdb	CLEAVED
MKCVFQA_1.pdb	CLEAVED
KAVRYQA_4.pdb	CLEAVED
RVCCYQA_4.pdb	CLEAVED
ILVDWQA_4.pdb	CLEAVED
NANAKQA_2.pdb	CLEAVED
RMPAFQA_2.pdb	CLEAVED
KPTSAQA_3.pdb	CLEAVED
AATVSQA_2.pdb	CLEAVED
HNRLRQA_1.pdb	CLEAVED
MHRRFQA_1.pdb	CLEAVED
ISVWWQA_0.pdb	CLEAVED
NVVSHQA_2.pdb	CLEAVED
WRVRYQA_4.pdb	CLEAVED
RHARYQA_3.pdb	CLEAVED
SDEPLQA_2.pdb	CLEAVED
LQVVGQA_0.pdb	CLEAVED
VTCTFQA_2.pdb	CLEAVED
LVVLYQA_4.pdb	CLEAVED
FGRCPQA_3.pdb	CLEAVED
YCVDYQA_0.pdb	CLEAVED
HHVCYQA_4.pdb	CLEAVED
RFVQHQA_4.pdb	CLEAVED
LPVHWQA_0.pdb	CLEAVED
EIHTYQA_4.pdb	CLEAVED
STRLYQA_4.pdb	CLEAVED
ISVMFQA_0.pdb	CLEAVED
RGFPSQA_3.pdb	CLEAVED
RLCAYQA_1.pdb	CLEAVED
FAFLIQA_0.pdb	CLEAVED
NCVSHQA_4.pdb	CLEAVED
TIAVYQA_3.pdb	CLEAVED
FRRWLQA_0.pdb	CLEAVED
IMQALQA_0.pdb	CLEAVED
QGVIYQA_4.pdb	CLEAVED
WHVRYQA_3.pdb	CLEAVED
VAVIYQA_4.pdb	CLEAVED
TPMRFQA_3.pdb	CLEAVED
EAVRYQA_0.pdb	CLEAVED
SRAEMQA_1.pdb	CLEAVED
RPVLFQA_3.pdb	CLEAVED
KAIQDQA_3.pdb	CLEAVED
WSFHWQA_3.pdb	CLEAVED
MHVVQQA_2.pdb	CLEAVED
LASCYQA_3.pdb	CLEAVED
FGVWYQA_1.pdb	CLEAVED
RNCRYQA_1.pdb	CLEAVED
SMSATQA_0.pdb	CLEAVED
RELSQQA_0.pdb	CLEAVED
NEGQRQA_0.pdb	CLEAVED
WNMLRQA_2.pdb	CLEAVED
CVPQFQA_4.pdb	CLEAVED
LLHTNQA_4.pdb	CLEAVED
QTRFDQA_3.pdb	CLEAVED
NWVEYQA_1.pdb	CLEAVED
GILRWQA_2.pdb	CLEAVED
GPSSLQA_3.pdb	CLEAVED
HECAYQA_3.pdb	CLEAVED
NFVWHQA_1.pdb	CLEAVED
VLMNRQA_0.pdb	CLEAVED
VSVVYQA_2.pdb	CLEAVED
LLSRSQA_2.pdb	CLEAVED
YWCTWQA_2.pdb	CLEAVED
WNVRYQA_2.pdb	CLEAVED
NKVVHQA_0.pdb	CLEAVED
YWDLTQA_1.pdb	UNCLEAVED
YTVRGQA_3.pdb	UNCLEAVED
LKLMCQA_4.pdb	UNCLEAVED
SLSDHQA_1.pdb	UNCLEAVED
SHKWIQA_2.pdb	UNCLEAVED
YLVSGQA_3.pdb	UNCLEAVED
HCMIPQA_0.pdb	UNCLEAVED
SKRICQA_0.pdb	UNCLEAVED
CVVIEQA_3.pdb	UNCLEAVED
RLCQMQA_2.pdb	UNCLEAVED
KGSWSQA_4.pdb	UNCLEAVED
FPPVFQA_2.pdb	UNCLEAVED
LCCGTQA_2.pdb	UNCLEAVED
LCSKEQA_0.pdb	UNCLEAVED
YARSGQA_2.pdb	UNCLEAVED
YWRTRQA_0.pdb	UNCLEAVED
QYTSRQA_1.pdb	UNCLEAVED
PDITMQA_4.pdb	UNCLEAVED
SIQCVQA_3.pdb	UNCLEAVED
SRKGRQA_3.pdb	UNCLEAVED
MCHSYQA_1.pdb	UNCLEAVED
TESRKQA_0.pdb	UNCLEAVED
TKMLEQA_2.pdb	UNCLEAVED
SESGLQA_3.pdb	UNCLEAVED
FSWMFQA_4.pdb	UNCLEAVED
NRAGTQA_0.pdb	UNCLEAVED
IGSRDQA_4.pdb	UNCLEAVED
DTILNQA_3.pdb	UNCLEAVED
LSIKSQA_4.pdb	UNCLEAVED
VVYHGQA_0.pdb	UNCLEAVED
LAVYPQA_2.pdb	UNCLEAVED
WSFTCQA_2.pdb	UNCLEAVED
VRYRGQA_3.pdb	UNCLEAVED
KDYVRQA_4.pdb	UNCLEAVED
RCWPKQA_0.pdb	UNCLEAVED
CLLLIQA_0.pdb	UNCLEAVED
YMWYRQA_2.pdb	UNCLEAVED
VSGSFQA_0.pdb	UNCLEAVED
PRILCQA_0.pdb	UNCLEAVED
DGSISQA_4.pdb	UNCLEAVED
EPGRPQA_2.pdb	UNCLEAVED
YAWCDQA_2.pdb	UNCLEAVED
LTKLEQA_4.pdb	UNCLEAVED
GRIWTQA_0.pdb	UNCLEAVED
ALLRQQA_2.pdb	UNCLEAVED
LLWDDQA_4.pdb	UNCLEAVED
LLHPYQA_0.pdb	UNCLEAVED
FHLRVQA_4.pdb	UNCLEAVED
RYRLPQA_4.pdb	UNCLEAVED
TLWMSQA_1.pdb	UNCLEAVED
LQCRRQA_0.pdb	UNCLEAVED
KCPAVQA_3.pdb	UNCLEAVED
FDATTQA_2.pdb	UNCLEAVED
WLAGLQA_3.pdb	UNCLEAVED
PPGRVQA_1.pdb	UNCLEAVED
TWGYPQA_1.pdb	UNCLEAVED
LGRPTQA_2.pdb	UNCLEAVED
LGMPVQA_2.pdb	UNCLEAVED
QLLLEQA_3.pdb	UNCLEAVED
WKHGCQA_3.pdb	UNCLEAVED
HWLRLQA_1.pdb	UNCLEAVED
RGGLRQA_0.pdb	UNCLEAVED
LIWVGQA_1.pdb	UNCLEAVED
NQDWKQA_2.pdb	UNCLEAVED
RHTTSQA_0.pdb	UNCLEAVED
PWLVHQA_0.pdb	UNCLEAVED
LFRMNQA_4.pdb	UNCLEAVED
LLACPQA_3.pdb	UNCLEAVED
VSTVMQA_4.pdb	UNCLEAVED
FLGAPQA_2.pdb	UNCLEAVED
GYVSSQA_0.pdb	UNCLEAVED
FVRISQA_3.pdb	UNCLEAVED
DHSSYQA_0.pdb	UNCLEAVED
CEFCCQA_0.pdb	UNCLEAVED
IELSSQA_2.pdb	UNCLEAVED
RPIAPQA_3.pdb	UNCLEAVED
HAARCQA_3.pdb	UNCLEAVED
PSSHGQA_0.pdb	UNCLEAVED
KLTRMQA_0.pdb	UNCLEAVED
SFFCGQA_4.pdb	UNCLEAVED
LVRWYQA_1.pdb	UNCLEAVED
FGTNMQA_4.pdb	UNCLEAVED
ALECAQA_4.pdb	UNCLEAVED
VRNNVQA_2.pdb	UNCLEAVED
SPSQGQA_3.pdb	UNCLEAVED
YRHRLQA_3.pdb	UNCLEAVED
PPSLRQA_0.pdb	UNCLEAVED
NTVVMQA_1.pdb	UNCLEAVED
RFGDWQA_4.pdb	UNCLEAVED
QLSHRQA_2.pdb	UNCLEAVED
GSHCRQA_0.pdb	UNCLEAVED
HFRFYQA_0.pdb	UNCLEAVED
YMANYQA_0.pdb	UNCLEAVED
SGGWAQA_4.pdb	UNCLEAVED
ENLYVQS_3.pdb	UNCLEAVED
SQLQYQA_4.pdb	UNCLEAVED
LPGSRQA_1.pdb	UNCLEAVED
WLDLVQA_2.pdb	UNCLEAVED
LVGWYQA_0.pdb	UNCLEAVED
RCTLYQA_1.pdb	UNCLEAVED
QGCRCQA_0.pdb	UNCLEAVED
CLDGRQA_3.pdb	UNCLEAVED
RPQRGQA_0.pdb	UNCLEAVED
LFGWQQA_4.pdb	UNCLEAVED
FLEVHQA_2.pdb	UNCLEAVED
RCQAAQA_3.pdb	UNCLEAVED
YKLSQQA_0.pdb	UNCLEAVED
YCLDGQA_3.pdb	UNCLEAVED
RTISIQA_1.pdb	UNCLEAVED
RRPRQQA_1.pdb	UNCLEAVED
GVWLPQA_2.pdb	UNCLEAVED
HCMARQA_2.pdb	UNCLEAVED
WGMGSQA_0.pdb	UNCLEAVED
YLFAFQA_2.pdb	UNCLEAVED
LGKLAQA_2.pdb	UNCLEAVED
ELRRWQA_0.pdb	UNCLEAVED
MWGGAQA_3.pdb	UNCLEAVED
RMVMGQA_2.pdb	UNCLEAVED
CPVMRQA_0.pdb	UNCLEAVED
DGKMDQA_4.pdb	UNCLEAVED
QLDCGQA_1.pdb	UNCLEAVED
RRKYAQA_4.pdb	UNCLEAVED
LLSVSQA_1.pdb	UNCLEAVED
MVWDLQA_3.pdb	UNCLEAVED
ADHFVQA_3.pdb	UNCLEAVED
VRQEVQA_2.pdb	UNCLEAVED
GKFFVQA_0.pdb	UNCLEAVED
RELLWQA_0.pdb	UNCLEAVED
RIVRGQA_3.pdb	UNCLEAVED
CRIRYQA_4.pdb	UNCLEAVED
AYVSRQA_3.pdb	UNCLEAVED
TVLGSQA_1.pdb	UNCLEAVED
LRPMSQA_0.pdb	UNCLEAVED
TSFFFQA_4.pdb	UNCLEAVED
NGGHQQA_3.pdb	UNCLEAVED
VSSVLQA_4.pdb	UNCLEAVED
GCMGAQA_1.pdb	UNCLEAVED
CPRMPQA_0.pdb	UNCLEAVED
TFIPNQA_1.pdb	UNCLEAVED
DNYTNQA_2.pdb	UNCLEAVED
RSATEQA_0.pdb	UNCLEAVED
NALWIQA_0.pdb	UNCLEAVED
SSPVTQA_4.pdb	UNCLEAVED
YGYSQQA_2.pdb	UNCLEAVED
WRYSSQA_4.pdb	UNCLEAVED
YHSGRQA_2.pdb	UNCLEAVED
ENLSFQS_1.pdb	UNCLEAVED
VNLYFQS_1.pdb	UNCLEAVED
YRNSAQA_0.pdb	UNCLEAVED
HFFRVQA_4.pdb	UNCLEAVED
TCHTCQA_4.pdb	UNCLEAVED
TRHDRQA_3.pdb	UNCLEAVED
LSMYAQA_1.pdb	UNCLEAVED
ASDGAQA_1.pdb	UNCLEAVED
LCVVPQA_4.pdb	UNCLEAVED
LWRYGQA_0.pdb	UNCLEAVED
PLMGVQA_2.pdb	UNCLEAVED
RDSMRQA_0.pdb	UNCLEAVED
MVDVKQA_0.pdb	UNCLEAVED
MRNSTQA_3.pdb	UNCLEAVED
RSNNSQA_1.pdb	UNCLEAVED
LLSFMQA_0.pdb	UNCLEAVED
KRWMSQA_0.pdb	UNCLEAVED
CAADVQA_2.pdb	UNCLEAVED
KGTVAQA_4.pdb	UNCLEAVED
DVRWAQA_3.pdb	UNCLEAVED
SRGVLQA_2.pdb	UNCLEAVED
VWCARQA_2.pdb	UNCLEAVED
FWGDFQA_0.pdb	UNCLEAVED
SQLSNQA_3.pdb	UNCLEAVED
LRSIEQA_2.pdb	UNCLEAVED
SRTGNQA_1.pdb	UNCLEAVED
ICCARQA_1.pdb	UNCLEAVED
IGMCLQA_3.pdb	UNCLEAVED
RGSAFQA_3.pdb	UNCLEAVED
HVLLGQA_1.pdb	UNCLEAVED
SVWLLQA_1.pdb	UNCLEAVED
KGRSGQA_4.pdb	UNCLEAVED
MPNKVQA_3.pdb	UNCLEAVED
LSGHGQA_2.pdb	UNCLEAVED
RIQVMQA_0.pdb	UNCLEAVED
VGYGRQA_1.pdb	UNCLEAVED
VLATKQA_1.pdb	UNCLEAVED
YGARTQA_3.pdb	UNCLEAVED
LGHWVQA_0.pdb	UNCLEAVED
GCEGTQA_0.pdb	UNCLEAVED
AGLCDQA_0.pdb	UNCLEAVED
GFVALQA_1.pdb	UNCLEAVED
PRVECQA_2.pdb	UNCLEAVED
RYTFRQA_2.pdb	UNCLEAVED
HVKLIQA_2.pdb	UNCLEAVED
MWKLQQA_2.pdb	UNCLEAVED
RSMNKQA_1.pdb	UNCLEAVED
SLRVAQA_3.pdb	UNCLEAVED
GSMQAQA_0.pdb	UNCLEAVED
YLGGEQA_3.pdb	UNCLEAVED
YLAVGQA_0.pdb	UNCLEAVED
VRTSLQA_3.pdb	UNCLEAVED
RHGGQQA_0.pdb	UNCLEAVED
RLTMEQA_1.pdb	UNCLEAVED
RRRQKQA_3.pdb	UNCLEAVED
WRATMQA_0.pdb	UNCLEAVED
NIRIGQA_2.pdb	UNCLEAVED
LSVLVQA_0.pdb	UNCLEAVED
CPRGGQA_4.pdb	UNCLEAVED
ACLSPQA_1.pdb	UNCLEAVED
WHKLEQA_2.pdb	UNCLEAVED
FARVLQA_2.pdb	UNCLEAVED
QVMGTQA_0.pdb	UNCLEAVED
MTHLPQA_1.pdb	UNCLEAVED
NSLWVQA_0.pdb	UNCLEAVED
STSNRQA_4.pdb	UNCLEAVED
HYLPEQA_3.pdb	UNCLEAVED
MTCAMQA_1.pdb	UNCLEAVED
LHIHVQA_0.pdb	UNCLEAVED
RVLVLQA_2.pdb	UNCLEAVED
NATSWQA_0.pdb	UNCLEAVED
SGGGLQA_1.pdb	UNCLEAVED
LGWTSQA_1.pdb	UNCLEAVED
PFDGVQA_4.pdb	UNCLEAVED
TWRMRQA_4.pdb	UNCLEAVED
GDTILQA_1.pdb	UNCLEAVED
FKELAQA_4.pdb	UNCLEAVED
ASMVWQA_0.pdb	UNCLEAVED
GSGRRQA_2.pdb	UNCLEAVED
AWVSFQA_2.pdb	UNCLEAVED
KHSSTQA_4.pdb	UNCLEAVED
MSTVIQA_0.pdb	UNCLEAVED
LFGFNQA_1.pdb	UNCLEAVED
LSGTGQA_1.pdb	UNCLEAVED
ILGDRQA_4.pdb	UNCLEAVED
WTVPCQA_4.pdb	UNCLEAVED
LLCLTQA_0.pdb	UNCLEAVED
CRTLSQA_2.pdb	UNCLEAVED
VLIVNQA_3.pdb	UNCLEAVED
VAHANQA_1.pdb	UNCLEAVED
ASVMNQA_4.pdb	UNCLEAVED
KVPGWQA_1.pdb	UNCLEAVED
SRSRSQA_0.pdb	UNCLEAVED
SAFRAQA_1.pdb	UNCLEAVED
RGYALQA_3.pdb	UNCLEAVED
ERLARQA_0.pdb	UNCLEAVED
PLDGAQA_2.pdb	UNCLEAVED
ISHQVQA_0.pdb	UNCLEAVED
GDMMNQA_1.pdb	UNCLEAVED
LLYRLQA_2.pdb	UNCLEAVED
DSVQLQA_0.pdb	UNCLEAVED
LGVKGQA_2.pdb	UNCLEAVED
RNLLLQA_2.pdb	UNCLEAVED
VAMCCQA_2.pdb	UNCLEAVED
RMYVNQA_1.pdb	UNCLEAVED
CNRIYQA_3.pdb	UNCLEAVED
SWSRYQA_4.pdb	UNCLEAVED
KGDVGQA_4.pdb	UNCLEAVED
PSYDQQA_3.pdb	UNCLEAVED
SPPCGQA_0.pdb	UNCLEAVED
LLYCAQA_1.pdb	UNCLEAVED
CLPHCQA_3.pdb	UNCLEAVED
RCRRGQA_1.pdb	UNCLEAVED
NTRHSQA_4.pdb	UNCLEAVED
LCTALQA_2.pdb	UNCLEAVED
VWLCGQA_2.pdb	UNCLEAVED
RYEIDQA_2.pdb	UNCLEAVED
YLSTWQA_2.pdb	UNCLEAVED
VRLCVQA_2.pdb	UNCLEAVED
TVMAMQA_3.pdb	UNCLEAVED
RTEKWQA_4.pdb	UNCLEAVED
TCRWHQA_0.pdb	UNCLEAVED
NMISVQA_3.pdb	UNCLEAVED
VRNLPQA_1.pdb	UNCLEAVED
MTTRRQA_2.pdb	UNCLEAVED
WSRACQA_0.pdb	UNCLEAVED
AKPARQA_2.pdb	UNCLEAVED
ASCSSQA_3.pdb	UNCLEAVED
CNHSRQA_0.pdb	UNCLEAVED
CWRESQA_3.pdb	UNCLEAVED
NLRTVQA_3.pdb	UNCLEAVED
EYRGQQA_1.pdb	UNCLEAVED
KFFASQA_0.pdb	UNCLEAVED
FTTSGQA_2.pdb	UNCLEAVED
ESISLQA_4.pdb	UNCLEAVED
NSVALQA_4.pdb	UNCLEAVED
CSCSSQA_0.pdb	UNCLEAVED
YRNARQA_3.pdb	UNCLEAVED
YDSERQA_1.pdb	UNCLEAVED
CCGLSQA_0.pdb	UNCLEAVED
LQHPNQA_3.pdb	UNCLEAVED
VRNAVQA_4.pdb	UNCLEAVED
DLFTHQA_2.pdb	UNCLEAVED
VLLAVQA_2.pdb	UNCLEAVED
GYAYGQA_3.pdb	UNCLEAVED
LSGSSQA_3.pdb	UNCLEAVED
ECFEGQA_4.pdb	UNCLEAVED
YQPVLQA_2.pdb	UNCLEAVED
LGFLWQA_2.pdb	UNCLEAVED
LPDGPQA_1.pdb	UNCLEAVED
LVSQWQA_0.pdb	UNCLEAVED
YRVMPQA_0.pdb	UNCLEAVED
STHLCQA_3.pdb	UNCLEAVED
TAVSRQA_1.pdb	UNCLEAVED
EWYLQQA_3.pdb	UNCLEAVED
PCRLRQA_3.pdb	UNCLEAVED
SKTVSQA_0.pdb	UNCLEAVED
VTDGKQA_3.pdb	UNCLEAVED
WGVLCQA_1.pdb	UNCLEAVED
SREVYQA_0.pdb	UNCLEAVED
WESHNQA_1.pdb	UNCLEAVED
VPFTRQA_2.pdb	UNCLEAVED
ERVLSQA_4.pdb	UNCLEAVED
RADWTQA_3.pdb	UNCLEAVED
RVSRLQA_1.pdb	UNCLEAVED
WYCSPQA_2.pdb	UNCLEAVED
SLGHGQA_3.pdb	UNCLEAVED
SFRCAQA_1.pdb	UNCLEAVED
SMYLNQA_1.pdb	UNCLEAVED
RGPIWQA_0.pdb	UNCLEAVED
LNENVQA_2.pdb	UNCLEAVED
SGLACQA_1.pdb	UNCLEAVED
KAGGAQA_3.pdb	UNCLEAVED
TSCPRQA_4.pdb	UNCLEAVED
YRLVLQA_4.pdb	UNCLEAVED
DSVSGQA_4.pdb	UNCLEAVED
CVKVTQA_2.pdb	UNCLEAVED
TWPRVQA_3.pdb	UNCLEAVED
VQMRLQA_4.pdb	UNCLEAVED
SPWRFQA_2.pdb	UNCLEAVED
KKLFCQA_2.pdb	UNCLEAVED
QYYRNQA_2.pdb	UNCLEAVED
ICAYRQA_0.pdb	UNCLEAVED
RVPQGQA_0.pdb	UNCLEAVED
SDVLVQA_4.pdb	UNCLEAVED
IICFTQA_1.pdb	UNCLEAVED
DVWVGQA_4.pdb	UNCLEAVED
AVRLIQA_1.pdb	UNCLEAVED
SVGPRQA_4.pdb	UNCLEAVED
AWVSVQA_4.pdb	UNCLEAVED
MHSRAQA_1.pdb	UNCLEAVED
YGAGRQA_0.pdb	UNCLEAVED
RCGWFQA_0.pdb	UNCLEAVED
DVCGLQA_2.pdb	UNCLEAVED
DRMEWQA_3.pdb	UNCLEAVED
LWSYGQA_0.pdb	UNCLEAVED
AGTPRQA_1.pdb	UNCLEAVED
TRDVFQA_3.pdb	UNCLEAVED
EDRFTQA_3.pdb	UNCLEAVED
VPSVPQA_1.pdb	UNCLEAVED
FRAGNQA_3.pdb	UNCLEAVED
RRSQAQA_2.pdb	UNCLEAVED
SFRQLQA_2.pdb	UNCLEAVED
PGRGCQA_4.pdb	UNCLEAVED
KWRCNQA_0.pdb	UNCLEAVED
KELAHQA_1.pdb	UNCLEAVED
WKLSAQA_2.pdb	UNCLEAVED
FDGIYQA_1.pdb	UNCLEAVED
YLQCGQA_2.pdb	UNCLEAVED
TLAFVQA_0.pdb	UNCLEAVED
NGDWWQA_2.pdb	UNCLEAVED
LRYSCQA_0.pdb	UNCLEAVED
SCVGSQA_3.pdb	UNCLEAVED
TFVCTQA_2.pdb	UNCLEAVED
WMSLNQA_1.pdb	UNCLEAVED
RYCASQA_3.pdb	UNCLEAVED
YWLALQA_2.pdb	UNCLEAVED
SGRSRQA_4.pdb	UNCLEAVED
RVMVSQA_4.pdb	UNCLEAVED
LFRALQA_3.pdb	UNCLEAVED
HGMSSQA_0.pdb	UNCLEAVED
WVSLGQA_3.pdb	UNCLEAVED
FATLRQA_3.pdb	UNCLEAVED
TVPSSQA_3.pdb	UNCLEAVED
DPVVAQA_0.pdb	UNCLEAVED
CSCLTQA_3.pdb	UNCLEAVED
CYAWPQA_4.pdb	UNCLEAVED
WHRGYQA_1.pdb	UNCLEAVED
CTGRNQA_2.pdb	UNCLEAVED
WWGVCQA_4.pdb	UNCLEAVED
LGTTCQA_0.pdb	UNCLEAVED
TLSMGQA_1.pdb	UNCLEAVED
HHHWMQA_4.pdb	UNCLEAVED
QRLRVQA_0.pdb	UNCLEAVED
GCTYRQA_3.pdb	UNCLEAVED
VFHLLQA_4.pdb	UNCLEAVED
YGVHVQA_2.pdb	UNCLEAVED
LRTVAQA_2.pdb	UNCLEAVED
WLRWRQS_0.pdb	UNCLEAVED
GSGFCQA_4.pdb	UNCLEAVED
SFRWYQA_3.pdb	UNCLEAVED
YLAVYQA_1.pdb	UNCLEAVED
PYVRTQA_0.pdb	UNCLEAVED
RACRAQA_2.pdb	UNCLEAVED
MCQGAQA_3.pdb	UNCLEAVED
FPFFFQA_3.pdb	UNCLEAVED
YACGVQA_1.pdb	UNCLEAVED
SKMMYQA_4.pdb	UNCLEAVED
WHWYYQA_3.pdb	UNCLEAVED
GCVHCQA_0.pdb	UNCLEAVED
CFAGYQA_2.pdb	UNCLEAVED
STTGGQA_3.pdb	UNCLEAVED
IRHHSQA_1.pdb	UNCLEAVED
VRRGSQA_2.pdb	UNCLEAVED
WLPMQQA_3.pdb	UNCLEAVED
SGLRDQA_2.pdb	UNCLEAVED
VRLVLQA_1.pdb	UNCLEAVED
VWMLVQA_0.pdb	UNCLEAVED
ICTTIQA_2.pdb	UNCLEAVED
YQGDFQA_0.pdb	UNCLEAVED
VFTVYQA_0.pdb	UNCLEAVED
ALSKIQA_1.pdb	UNCLEAVED
FWPTYQA_1.pdb	UNCLEAVED
KTGVCQA_4.pdb	UNCLEAVED
HCLGCQA_0.pdb	UNCLEAVED
MYGQYQA_3.pdb	UNCLEAVED
NRDRSQA_2.pdb	UNCLEAVED
RWHVAQA_4.pdb	UNCLEAVED
WKCTRQA_1.pdb	UNCLEAVED
RWRCSQA_1.pdb	UNCLEAVED
LLSMEQA_0.pdb	UNCLEAVED
HVCERQA_3.pdb	UNCLEAVED
RCVATQA_3.pdb	UNCLEAVED
QSRMHQA_0.pdb	UNCLEAVED
HRATAQA_1.pdb	UNCLEAVED
ICGFWQA_1.pdb	UNCLEAVED
ERQVRQA_3.pdb	UNCLEAVED
HSVVCQA_0.pdb	UNCLEAVED
SFNSKQA_3.pdb	UNCLEAVED
YCGATQA_3.pdb	UNCLEAVED
WRYCRQA_2.pdb	UNCLEAVED
FDSLFQA_2.pdb	UNCLEAVED
GVLKHQA_0.pdb	UNCLEAVED
NARPEQA_1.pdb	UNCLEAVED
ENETCQA_2.pdb	UNCLEAVED
LHLGYQA_1.pdb	UNCLEAVED
YLALNQA_1.pdb	UNCLEAVED
IRKYDQA_2.pdb	UNCLEAVED
RYHSWQA_4.pdb	UNCLEAVED
QNVYYQA_4.pdb	UNCLEAVED
CAQFPQA_1.pdb	UNCLEAVED
GPCTFQA_1.pdb	UNCLEAVED
VYYGRQA_2.pdb	UNCLEAVED
DWRRWQA_2.pdb	UNCLEAVED
WWCSHQA_0.pdb	UNCLEAVED
PGGRYQA_3.pdb	UNCLEAVED
RMCMVQA_4.pdb	UNCLEAVED
RRTMHQA_0.pdb	UNCLEAVED
VFLTAQA_2.pdb	UNCLEAVED
FLNRSQA_3.pdb	UNCLEAVED
FVTRHQA_3.pdb	UNCLEAVED
RCRVGQA_1.pdb	UNCLEAVED
LSWRSQA_4.pdb	UNCLEAVED
TCVCMQA_2.pdb	UNCLEAVED
VYLWCQA_0.pdb	UNCLEAVED
KPEEAQA_0.pdb	UNCLEAVED
HSLVVQA_3.pdb	UNCLEAVED
ISKCSQA_2.pdb	UNCLEAVED
QYVCCQA_1.pdb	UNCLEAVED
NFFAFQA_4.pdb	UNCLEAVED
RDILGQA_2.pdb	UNCLEAVED
SDRREQA_2.pdb	UNCLEAVED
DSYKYQA_4.pdb	UNCLEAVED
MLNGRQA_2.pdb	UNCLEAVED
FPMSKQA_3.pdb	UNCLEAVED
SEFVLQA_1.pdb	UNCLEAVED
RSARAQA_3.pdb	UNCLEAVED
TLCCVQA_4.pdb	UNCLEAVED
YLPCWQA_4.pdb	UNCLEAVED
DVTTAQA_1.pdb	UNCLEAVED
WTLQTQA_1.pdb	UNCLEAVED
AWQKEQA_4.pdb	UNCLEAVED
RLPFEQA_2.pdb	UNCLEAVED
SRLSLQA_4.pdb	UNCLEAVED
VTVALQA_3.pdb	UNCLEAVED
LSWRRQA_4.pdb	UNCLEAVED
FFVRTQA_0.pdb	UNCLEAVED
FLSSTQA_0.pdb	UNCLEAVED
HVAVGQA_3.pdb	UNCLEAVED
SRCKAQA_3.pdb	UNCLEAVED
VLKAGQA_4.pdb	UNCLEAVED
SYAMIQA_0.pdb	UNCLEAVED
ETAGLQA_4.pdb	UNCLEAVED
PCLMTQA_1.pdb	UNCLEAVED
SVYLFQA_0.pdb	UNCLEAVED
LSDACQA_1.pdb	UNCLEAVED
QAPQVQA_4.pdb	UNCLEAVED
SPDSFQA_1.pdb	UNCLEAVED
GTRNLQA_1.pdb	UNCLEAVED
ASIGWQA_0.pdb	UNCLEAVED
DYCVLQA_4.pdb	UNCLEAVED
YFRLYQA_1.pdb	UNCLEAVED
KCLSGQA_4.pdb	UNCLEAVED
VWSIMQA_3.pdb	UNCLEAVED
ENLLHQA_3.pdb	UNCLEAVED
RLWSLQA_3.pdb	UNCLEAVED
TCISWQA_0.pdb	UNCLEAVED
RDVVGQA_1.pdb	UNCLEAVED
ISLLRQA_4.pdb	UNCLEAVED
RGGRVQA_4.pdb	UNCLEAVED
LTSRPQA_3.pdb	UNCLEAVED
SWRVRQA_1.pdb	UNCLEAVED
VDELCQA_3.pdb	UNCLEAVED
TKVNRQA_1.pdb	UNCLEAVED
SLLWRQA_3.pdb	UNCLEAVED
YAYRVQA_1.pdb	UNCLEAVED
FSLHAQA_3.pdb	UNCLEAVED
IVVLEQA_0.pdb	UNCLEAVED
HNRRQQA_1.pdb	UNCLEAVED
TCTWCQA_4.pdb	UNCLEAVED
RLMCTQA_1.pdb	UNCLEAVED
AMSPPQA_2.pdb	UNCLEAVED
LRWLNQA_4.pdb	UNCLEAVED
CTCWRQA_1.pdb	UNCLEAVED
LLKGYQA_1.pdb	UNCLEAVED
LGVCTQA_0.pdb	UNCLEAVED
ICIWKQA_3.pdb	UNCLEAVED
LSLHQQA_1.pdb	UNCLEAVED
VYRYMQA_0.pdb	UNCLEAVED
NVHTKQA_0.pdb	UNCLEAVED
ARSQFQA_3.pdb	UNCLEAVED
RSFLQQA_4.pdb	UNCLEAVED
ARNQTQA_1.pdb	UNCLEAVED
LCFSYQA_3.pdb	UNCLEAVED
TGECYQA_4.pdb	UNCLEAVED
RPVCLQA_4.pdb	UNCLEAVED
RAHHWQA_1.pdb	UNCLEAVED
SVISEQA_3.pdb	UNCLEAVED
CWFMTQA_2.pdb	UNCLEAVED
DCRGGQA_4.pdb	UNCLEAVED
AQVYPQA_2.pdb	UNCLEAVED
PYRDKQA_1.pdb	UNCLEAVED
TPVVQQA_2.pdb	UNCLEAVED
FPFTFQA_3.pdb	UNCLEAVED
WVVQTQA_2.pdb	UNCLEAVED
RLSLDQA_3.pdb	UNCLEAVED
SVLVHQA_3.pdb	UNCLEAVED
ENGLEQA_4.pdb	UNCLEAVED
LSYSFQA_4.pdb	UNCLEAVED
VVCYLQA_1.pdb	UNCLEAVED
DVRTDQA_1.pdb	UNCLEAVED
CGWYWQA_1.pdb	UNCLEAVED
GHYLMQA_1.pdb	UNCLEAVED
HRRKMQA_1.pdb	UNCLEAVED
VMVRLQA_3.pdb	UNCLEAVED
GYAYNQA_4.pdb	UNCLEAVED
MFAMAQA_1.pdb	UNCLEAVED
LARQRQA_2.pdb	UNCLEAVED
YHGLMQA_2.pdb	UNCLEAVED
CLCAGQA_1.pdb	UNCLEAVED
WVRDLQA_0.pdb	UNCLEAVED
ATWVPQA_3.pdb	UNCLEAVED
RSKPGQA_3.pdb	UNCLEAVED
LCSRCQA_3.pdb	UNCLEAVED
DIGRMQA_2.pdb	UNCLEAVED
TICHGQA_3.pdb	UNCLEAVED
PSKVVQA_0.pdb	UNCLEAVED
QASFLQA_2.pdb	UNCLEAVED
KPSQIQA_4.pdb	UNCLEAVED
FELSYQA_4.pdb	UNCLEAVED
SSVVRQA_3.pdb	UNCLEAVED
SSEVVQA_3.pdb	UNCLEAVED
ARSDVQA_3.pdb	UNCLEAVED
HHRNLQA_2.pdb	UNCLEAVED
YEFKWQA_3.pdb	UNCLEAVED
CARSIQA_0.pdb	UNCLEAVED
PGFYDQA_2.pdb	UNCLEAVED
CTLVVQA_4.pdb	UNCLEAVED
VLSIMQA_0.pdb	UNCLEAVED
YASSKQA_4.pdb	UNCLEAVED
YVSERQA_3.pdb	UNCLEAVED
GLLFAQA_1.pdb	UNCLEAVED
LVFRHQA_0.pdb	UNCLEAVED
AFLTVQA_3.pdb	UNCLEAVED
RCRSQQA_4.pdb	UNCLEAVED
LTVLCQA_3.pdb	UNCLEAVED
YWWLNQA_3.pdb	UNCLEAVED
VCSNCQA_4.pdb	UNCLEAVED
LYRPLQA_3.pdb	UNCLEAVED
MGVQRQA_1.pdb	UNCLEAVED
PGSAWQA_4.pdb	UNCLEAVED
PGIEFQA_0.pdb	UNCLEAVED
TCTFAQA_2.pdb	UNCLEAVED
NCGWSQA_0.pdb	UNCLEAVED
CLSTWQA_4.pdb	UNCLEAVED
RLSCLQA_3.pdb	UNCLEAVED
YLDMVQA_2.pdb	UNCLEAVED
RRGLGQA_4.pdb	UNCLEAVED
FHSADQA_1.pdb	UNCLEAVED
FSGSYQA_4.pdb	UNCLEAVED
YLPCEQA_0.pdb	UNCLEAVED
LHITTQA_0.pdb	UNCLEAVED
HYLLSQA_1.pdb	UNCLEAVED
LDDPIQA_3.pdb	UNCLEAVED
LLSTIQA_4.pdb	UNCLEAVED
FRVVGQA_1.pdb	UNCLEAVED
PSPALQA_1.pdb	UNCLEAVED
HVSCFQA_1.pdb	UNCLEAVED
RSYVWQA_4.pdb	UNCLEAVED
HNTYRQA_0.pdb	UNCLEAVED
KSMSFQA_0.pdb	UNCLEAVED
WEGFVQA_1.pdb	UNCLEAVED
IQRLYQA_2.pdb	UNCLEAVED
RCAHQQA_4.pdb	UNCLEAVED
GYVHNQA_3.pdb	UNCLEAVED
SGTFSQA_0.pdb	UNCLEAVED
ERDQEQA_1.pdb	UNCLEAVED
NYTHVQA_2.pdb	UNCLEAVED
LVHLLQA_2.pdb	UNCLEAVED
RCERRQA_3.pdb	UNCLEAVED
NRYAFQA_0.pdb	UNCLEAVED
DHMCYQA_3.pdb	UNCLEAVED
LYSGWQA_3.pdb	UNCLEAVED
RLLQVQA_0.pdb	UNCLEAVED
CPRLMQA_1.pdb	UNCLEAVED
WHVMEQA_2.pdb	UNCLEAVED
RLCLRQA_1.pdb	UNCLEAVED
KECMWQA_4.pdb	UNCLEAVED
KVNLSQA_0.pdb	UNCLEAVED
RLPRSQA_2.pdb	UNCLEAVED
PHKCAQA_1.pdb	UNCLEAVED
GLYRNQA_3.pdb	UNCLEAVED
WMACLQA_2.pdb	UNCLEAVED
YPDCNQA_2.pdb	UNCLEAVED
NVPAGQA_1.pdb	UNCLEAVED
ESVVAQA_3.pdb	UNCLEAVED
SKCWSQA_0.pdb	UNCLEAVED
GDRGVQA_2.pdb	UNCLEAVED
HSMAVQA_4.pdb	UNCLEAVED
NAWLWQA_4.pdb	UNCLEAVED
SLSLNQA_0.pdb	UNCLEAVED
EFLMVQA_0.pdb	UNCLEAVED
DWRRFQA_1.pdb	UNCLEAVED
RTKIRQA_0.pdb	UNCLEAVED
YLACKQA_4.pdb	UNCLEAVED
IVCRLQA_4.pdb	UNCLEAVED
SLPHWQA_3.pdb	UNCLEAVED
LWNMGQA_1.pdb	UNCLEAVED
TVTFKQA_4.pdb	UNCLEAVED
SCMQAQA_3.pdb	UNCLEAVED
NPMILQA_1.pdb	UNCLEAVED
LWCGRQA_1.pdb	UNCLEAVED
VCTWFQA_3.pdb	UNCLEAVED
YGMFEQA_3.pdb	UNCLEAVED
RTLLRQA_3.pdb	UNCLEAVED
RDSHGQA_1.pdb	UNCLEAVED
LMVVDQA_0.pdb	UNCLEAVED
EPSMFQA_3.pdb	UNCLEAVED
EGWRLQA_3.pdb	UNCLEAVED
CRGVTQA_4.pdb	UNCLEAVED
DMGKSQA_2.pdb	UNCLEAVED
MIGGAQA_1.pdb	UNCLEAVED
SAEWLQA_2.pdb	UNCLEAVED
DVPWYQA_2.pdb	UNCLEAVED
TAGINQA_3.pdb	UNCLEAVED
AVALGQA_3.pdb	UNCLEAVED
LFNLRQA_0.pdb	UNCLEAVED
HMDTTQA_1.pdb	UNCLEAVED
AVSTKQA_3.pdb	UNCLEAVED
CSANFQA_0.pdb	UNCLEAVED
RFLGCQA_3.pdb	UNCLEAVED
EAVHMQA_4.pdb	UNCLEAVED
LDGVSQA_2.pdb	UNCLEAVED
NLSPAQA_3.pdb	UNCLEAVED
GKKLCQA_0.pdb	UNCLEAVED
SFSVQQA_0.pdb	UNCLEAVED
SFGSYQA_0.pdb	UNCLEAVED
ICWDHQA_4.pdb	UNCLEAVED
RCAEFQA_0.pdb	UNCLEAVED
LTFKFQA_0.pdb	UNCLEAVED
WTPRSQA_3.pdb	UNCLEAVED
MNPVVQA_4.pdb	UNCLEAVED
RYIDAQA_0.pdb	UNCLEAVED
LLDVSQA_1.pdb	UNCLEAVED
RYAGFQA_0.pdb	UNCLEAVED
RMGVLQA_0.pdb	UNCLEAVED
QLFHIQA_2.pdb	UNCLEAVED
HYEFYQA_0.pdb	UNCLEAVED
SGLMIQA_3.pdb	UNCLEAVED
PIGFIQA_2.pdb	UNCLEAVED
HCSCPQA_0.pdb	UNCLEAVED
ASYTMQA_3.pdb	UNCLEAVED
TGYPEQA_3.pdb	UNCLEAVED
MVYLKQA_0.pdb	UNCLEAVED
YWHRSQA_0.pdb	UNCLEAVED
VRVERQA_4.pdb	UNCLEAVED
GYCVCQA_0.pdb	UNCLEAVED
YVSGDQA_1.pdb	UNCLEAVED
SGGEDQA_2.pdb	UNCLEAVED
CAECGQA_1.pdb	UNCLEAVED
VRFTDQA_1.pdb	UNCLEAVED
ICGVAQA_3.pdb	UNCLEAVED
WYSCWQA_1.pdb	UNCLEAVED
RPLACQA_0.pdb	UNCLEAVED
GCRNLQA_1.pdb	UNCLEAVED
GRVMGQA_1.pdb	UNCLEAVED
LCFYWQA_0.pdb	UNCLEAVED
HPSNYQA_4.pdb	UNCLEAVED
CQVLMQA_2.pdb	UNCLEAVED
AGMVPQA_1.pdb	UNCLEAVED
SNTAWQA_1.pdb	UNCLEAVED
GSIESQA_2.pdb	UNCLEAVED
KGEGRQA_2.pdb	UNCLEAVED
MSMHVQA_1.pdb	UNCLEAVED
LSLFKQA_2.pdb	UNCLEAVED
FSWSQQA_0.pdb	UNCLEAVED
CNIGCQA_4.pdb	UNCLEAVED
LGNTRQA_4.pdb	UNCLEAVED
LANSEQA_3.pdb	UNCLEAVED
IMWSAQA_1.pdb	UNCLEAVED
RQVPCQA_3.pdb	UNCLEAVED
WLMRTQA_0.pdb	UNCLEAVED
RETCRQA_4.pdb	UNCLEAVED
SSEGGQA_3.pdb	UNCLEAVED
VYHGRQA_4.pdb	UNCLEAVED
TICWMQA_1.pdb	UNCLEAVED
SESPSQA_1.pdb	UNCLEAVED
RVSVWQA_4.pdb	UNCLEAVED
VMNAGQA_0.pdb	UNCLEAVED
LPRMVQA_1.pdb	UNCLEAVED
VNFCGQA_3.pdb	UNCLEAVED
SAALTQA_4.pdb	UNCLEAVED
YVLAGQA_2.pdb	UNCLEAVED
EESLWQA_0.pdb	UNCLEAVED
SLTNAQA_3.pdb	UNCLEAVED
ETAQMQA_2.pdb	UNCLEAVED
YCSSMQA_0.pdb	UNCLEAVED
CQHTYQA_3.pdb	UNCLEAVED
LVSLIQA_2.pdb	UNCLEAVED
CYIHVQA_1.pdb	UNCLEAVED
VMWTAQA_2.pdb	UNCLEAVED
GWYSFQA_4.pdb	UNCLEAVED
RARVYQA_2.pdb	UNCLEAVED
WLLGAQA_0.pdb	UNCLEAVED
SPLRAQA_0.pdb	UNCLEAVED
VNDYSQA_2.pdb	UNCLEAVED
HGDRPQA_3.pdb	UNCLEAVED
YASRWQA_0.pdb	UNCLEAVED
GGSGYQA_2.pdb	UNCLEAVED
PPGLLQA_2.pdb	UNCLEAVED
VVFLLQA_2.pdb	UNCLEAVED
ARIEKQA_2.pdb	UNCLEAVED
YLNDLQA_4.pdb	UNCLEAVED
VDSRVQA_1.pdb	UNCLEAVED
PNLLFQA_4.pdb	UNCLEAVED
HVTMSQA_2.pdb	UNCLEAVED
RILLMQA_2.pdb	UNCLEAVED
SQVSLQA_4.pdb	UNCLEAVED
GHRFSQA_1.pdb	UNCLEAVED
FSPVRQA_4.pdb	UNCLEAVED
ILSHGQA_2.pdb	UNCLEAVED
GYTWKQA_1.pdb	UNCLEAVED
VDNSSQA_2.pdb	UNCLEAVED
SCQWAQA_4.pdb	UNCLEAVED
RKTVVQA_3.pdb	UNCLEAVED
VMFTSQA_2.pdb	UNCLEAVED
LGLKVQA_4.pdb	UNCLEAVED
GSYFAQA_4.pdb	UNCLEAVED
GQSMGQA_4.pdb	UNCLEAVED
LRQYAQA_2.pdb	UNCLEAVED
CFHVCQA_0.pdb	UNCLEAVED
FRGELQA_0.pdb	UNCLEAVED
LIKFGQA_1.pdb	UNCLEAVED
GAGNNQA_4.pdb	UNCLEAVED
LCGATQA_2.pdb	UNCLEAVED
QGFGDQA_0.pdb	UNCLEAVED
FCCLLQA_1.pdb	UNCLEAVED
VNVSKQA_3.pdb	UNCLEAVED
VCHRCQA_0.pdb	UNCLEAVED
RSRCYQA_3.pdb	UNCLEAVED
RYGTNQA_4.pdb	UNCLEAVED
LLGTVQA_3.pdb	UNCLEAVED
DGGQCQA_3.pdb	UNCLEAVED
SMLLEQA_4.pdb	UNCLEAVED
RYSWSQA_1.pdb	UNCLEAVED
TWCNCQA_3.pdb	UNCLEAVED
SSRAVQA_0.pdb	UNCLEAVED
MPFAYQA_4.pdb	UNCLEAVED
SAAVSQA_3.pdb	UNCLEAVED
WYVCSQA_4.pdb	UNCLEAVED
VFTGAQA_3.pdb	UNCLEAVED
HGRRSQA_1.pdb	UNCLEAVED
DCVWPQA_3.pdb	UNCLEAVED
SPSICQA_4.pdb	UNCLEAVED
VGVHAQA_2.pdb	UNCLEAVED
LSVMWQA_3.pdb	UNCLEAVED
GSDTRQA_1.pdb	UNCLEAVED
SHKRIQA_4.pdb	UNCLEAVED
SHGMSQA_0.pdb	UNCLEAVED
SVYTEQA_2.pdb	UNCLEAVED
LAWLLQA_2.pdb	UNCLEAVED
RLMEGQA_1.pdb	UNCLEAVED
RSLWSQA_4.pdb	UNCLEAVED
CWFFLQA_2.pdb	UNCLEAVED
QKGCPQA_3.pdb	UNCLEAVED
SYADLQA_0.pdb	UNCLEAVED
YYIEGQA_4.pdb	UNCLEAVED
TRSMHQA_3.pdb	UNCLEAVED
VTCYCQA_1.pdb	UNCLEAVED
VISKAQA_3.pdb	UNCLEAVED
TSENPQA_0.pdb	UNCLEAVED
FSGYVQA_2.pdb	UNCLEAVED
GSAYLQA_0.pdb	UNCLEAVED
LSNSVQA_4.pdb	UNCLEAVED
DRQYYQA_3.pdb	UNCLEAVED
VDVRRQA_2.pdb	UNCLEAVED
DWDKFQA_3.pdb	UNCLEAVED
LDSWRQA_4.pdb	UNCLEAVED
DSYCHQA_2.pdb	UNCLEAVED
LRPSKQA_4.pdb	UNCLEAVED
TDLAQQA_1.pdb	UNCLEAVED
QLGSEQA_4.pdb	UNCLEAVED
HKAWTQA_3.pdb	UNCLEAVED
SGLSQQA_0.pdb	UNCLEAVED
MRLCHQA_0.pdb	UNCLEAVED
LYAAIQA_3.pdb	UNCLEAVED
SSHTAQA_0.pdb	UNCLEAVED
YKRVSQA_1.pdb	UNCLEAVED
LWALAQA_1.pdb	UNCLEAVED
TVMSLQA_2.pdb	UNCLEAVED
RFTYVQA_1.pdb	UNCLEAVED
PHCRVQA_2.pdb	UNCLEAVED
LPGHGQA_2.pdb	UNCLEAVED
WEVACQA_1.pdb	UNCLEAVED
HYSHNQA_3.pdb	UNCLEAVED
TEMCKQA_1.pdb	UNCLEAVED
IASVLQA_3.pdb	UNCLEAVED
SHCWCQA_3.pdb	UNCLEAVED
RLSVHQA_0.pdb	UNCLEAVED
IARHCQA_2.pdb	UNCLEAVED
RESHVQA_2.pdb	UNCLEAVED
HGSFAQA_2.pdb	UNCLEAVED
SRHVVQA_3.pdb	UNCLEAVED
MLMVNQA_1.pdb	UNCLEAVED
FFVYGQA_2.pdb	UNCLEAVED
CCTCGQA_3.pdb	UNCLEAVED
CGVVAQA_4.pdb	UNCLEAVED
ARTSSQA_4.pdb	UNCLEAVED
TYWNCQA_1.pdb	UNCLEAVED
SMNVCQA_2.pdb	UNCLEAVED
AYLGTQA_4.pdb	UNCLEAVED
YGGVMQA_3.pdb	UNCLEAVED
CDFHWQA_4.pdb	UNCLEAVED
TARPVQA_1.pdb	UNCLEAVED
TFYSSQA_1.pdb	UNCLEAVED
QGYVRQA_4.pdb	UNCLEAVED
RTRFLQA_3.pdb	UNCLEAVED
ILTDMQA_3.pdb	UNCLEAVED
SNGCCQA_2.pdb	UNCLEAVED
PRDSEQA_1.pdb	UNCLEAVED
RDEEVQA_1.pdb	UNCLEAVED
SKGMVQA_3.pdb	UNCLEAVED
CNDCPQA_1.pdb	UNCLEAVED
SVKHRQA_3.pdb	UNCLEAVED
SGMLMQA_3.pdb	UNCLEAVED
RCRVWQA_4.pdb	UNCLEAVED
GCTRTQA_1.pdb	UNCLEAVED
AQVILQA_2.pdb	UNCLEAVED
TLCLVQA_3.pdb	UNCLEAVED
WLMPHQA_3.pdb	UNCLEAVED
GLGRTQA_4.pdb	UNCLEAVED
WSLRVQA_4.pdb	UNCLEAVED
LPSTHQA_0.pdb	UNCLEAVED
ACVNSQA_2.pdb	UNCLEAVED
YVLLHQA_3.pdb	UNCLEAVED
RCDNGQA_2.pdb	UNCLEAVED
CCHPAQA_2.pdb	UNCLEAVED
NQAYPQA_1.pdb	UNCLEAVED
RVLMMQA_1.pdb	UNCLEAVED
STGCAQA_2.pdb	UNCLEAVED
CHFGVQA_1.pdb	UNCLEAVED
LFGLAQA_0.pdb	UNCLEAVED
SCCGAQA_2.pdb	UNCLEAVED
SPVDGQA_4.pdb	UNCLEAVED
KLTTSQA_3.pdb	UNCLEAVED
LGTVSQA_3.pdb	UNCLEAVED
SRECVQA_1.pdb	UNCLEAVED
AWSTGQA_4.pdb	UNCLEAVED
PLMLQQA_4.pdb	UNCLEAVED
ESSLRQA_1.pdb	UNCLEAVED
LFAVNQA_0.pdb	UNCLEAVED
NWKPKQA_0.pdb	UNCLEAVED
NVVTQQA_2.pdb	UNCLEAVED
WMVTQQA_4.pdb	UNCLEAVED
SLHSCQA_3.pdb	UNCLEAVED
WGGYPQA_0.pdb	UNCLEAVED
YERSMQA_1.pdb	UNCLEAVED
KLLEPQA_2.pdb	UNCLEAVED
FLLPMQA_0.pdb	UNCLEAVED
ASPNEQA_0.pdb	UNCLEAVED
CSGDRQA_0.pdb	UNCLEAVED
VQGVSQA_3.pdb	UNCLEAVED
LCLFGQA_1.pdb	UNCLEAVED
PAGECQA_1.pdb	UNCLEAVED
RFPMVQA_4.pdb	UNCLEAVED
SPKRQQA_2.pdb	UNCLEAVED
PVSRQQA_3.pdb	UNCLEAVED
RTWVEQA_0.pdb	UNCLEAVED
MGVHRQA_3.pdb	UNCLEAVED
VGGGSQA_4.pdb	UNCLEAVED
GCTRAQA_0.pdb	UNCLEAVED
ISVFSQA_0.pdb	UNCLEAVED
SREERQA_1.pdb	UNCLEAVED
RGIGCQA_1.pdb	UNCLEAVED
VAGLLQA_1.pdb	UNCLEAVED
WYMVHQA_2.pdb	UNCLEAVED
RHSWDQA_1.pdb	UNCLEAVED
WWRIKQA_1.pdb	UNCLEAVED
WRVLSQA_3.pdb	UNCLEAVED
SCGSKQA_2.pdb	UNCLEAVED
MKMCAQA_0.pdb	UNCLEAVED
HGVHAQA_3.pdb	UNCLEAVED
HDDRGQA_2.pdb	UNCLEAVED
ICGVLQA_1.pdb	UNCLEAVED
WRCGAQA_3.pdb	UNCLEAVED
SKQCNQA_3.pdb	UNCLEAVED
WALCSQA_0.pdb	UNCLEAVED
RMLLVQA_1.pdb	UNCLEAVED
SCRLTQA_3.pdb	UNCLEAVED
PFGSRQA_2.pdb	UNCLEAVED
MCHRWQA_1.pdb	UNCLEAVED
NWLHIQA_2.pdb	UNCLEAVED
LATRLQA_3.pdb	UNCLEAVED
IWLLCQA_1.pdb	UNCLEAVED
PSQDLQA_3.pdb	UNCLEAVED
CGPLLQA_1.pdb	UNCLEAVED
YECRCQA_3.pdb	UNCLEAVED
SVFVAQA_1.pdb	UNCLEAVED
AISGDQA_2.pdb	UNCLEAVED
GIVSQQA_3.pdb	UNCLEAVED
CGTRAQA_3.pdb	UNCLEAVED
LRSAHQA_2.pdb	UNCLEAVED
NAYGVQA_1.pdb	UNCLEAVED
VFGAVQA_2.pdb	UNCLEAVED
KPNSMQA_1.pdb	UNCLEAVED
RCASLQA_3.pdb	UNCLEAVED
HARSYQA_4.pdb	UNCLEAVED
CEQRVQA_3.pdb	UNCLEAVED
SVNKIQA_1.pdb	UNCLEAVED
YVNEVQA_0.pdb	UNCLEAVED
ETLYFQS_3.pdb	UNCLEAVED
SVRTSQA_3.pdb	UNCLEAVED
CIGYKQA_0.pdb	UNCLEAVED
FTIWYQA_2.pdb	UNCLEAVED
LTDGVQA_3.pdb	UNCLEAVED
MRDLGQA_4.pdb	UNCLEAVED
ENLDFQS_0.pdb	UNCLEAVED
ASVYAQA_3.pdb	UNCLEAVED
EILYFQS_2.pdb	UNCLEAVED
LLWNRQA_3.pdb	UNCLEAVED
YIPVIQA_4.pdb	UNCLEAVED
LVVTSQA_2.pdb	UNCLEAVED
TLMEVQA_1.pdb	UNCLEAVED
DVLRIQS_4.pdb	UNCLEAVED
VSRLVQA_1.pdb	UNCLEAVED
TVRTKQA_3.pdb	UNCLEAVED
RLHTLQA_1.pdb	UNCLEAVED
PLGSAQA_3.pdb	UNCLEAVED
WLLTGQA_4.pdb	UNCLEAVED
YWSELQA_1.pdb	UNCLEAVED
MFSAYQA_2.pdb	UNCLEAVED
KVGKNQA_0.pdb	UNCLEAVED
WSNHRQA_0.pdb	UNCLEAVED
TVQEGQA_0.pdb	UNCLEAVED
LLKIHQA_2.pdb	UNCLEAVED
PCIFAQA_1.pdb	UNCLEAVED
SWGFLQA_1.pdb	UNCLEAVED
KIMMVQA_3.pdb	UNCLEAVED
DKFIKQA_4.pdb	UNCLEAVED
WSSASQA_2.pdb	UNCLEAVED
VGVGEQA_3.pdb	UNCLEAVED
DEVRLQA_2.pdb	UNCLEAVED
RSTQDQA_4.pdb	UNCLEAVED
CVGIVQA_1.pdb	UNCLEAVED
RCRTRQA_3.pdb	UNCLEAVED
ARSGRQA_0.pdb	UNCLEAVED
GSEFGQA_2.pdb	UNCLEAVED
RNESVQA_3.pdb	UNCLEAVED
SLRVSQA_2.pdb	UNCLEAVED
LLSTRQA_1.pdb	UNCLEAVED
LRWLRQA_4.pdb	UNCLEAVED
SMDNLQA_1.pdb	UNCLEAVED
QFPVRQA_2.pdb	UNCLEAVED
FTNMMQA_1.pdb	UNCLEAVED
MRFHLQA_4.pdb	UNCLEAVED
SGEEHQA_1.pdb	UNCLEAVED
ALGVFQA_4.pdb	UNCLEAVED
FFHTHQA_1.pdb	UNCLEAVED
SELTLQA_4.pdb	UNCLEAVED
LESRFQA_1.pdb	UNCLEAVED
DVPSWQA_0.pdb	UNCLEAVED
WIGHCQA_0.pdb	UNCLEAVED
LAKAYQA_3.pdb	UNCLEAVED
LDEVRQA_3.pdb	UNCLEAVED
SVLFRQA_3.pdb	UNCLEAVED
RFYDYQA_1.pdb	UNCLEAVED
RRCSLQA_1.pdb	UNCLEAVED
WSWQMQA_1.pdb	UNCLEAVED
RDTPSQA_2.pdb	UNCLEAVED
RYCLVQA_1.pdb	UNCLEAVED
RWIQHQA_4.pdb	UNCLEAVED
WSSHCQA_3.pdb	UNCLEAVED
CSEYQQA_1.pdb	UNCLEAVED
LMSDVQA_4.pdb	UNCLEAVED
QELSCQA_0.pdb	UNCLEAVED
IVGCMQA_4.pdb	UNCLEAVED
QYGKTQA_4.pdb	UNCLEAVED
YRTVRQA_1.pdb	UNCLEAVED
LSLAGQA_4.pdb	UNCLEAVED
WVYLVQA_1.pdb	UNCLEAVED
PPDSGQA_0.pdb	UNCLEAVED
GVMLTQA_4.pdb	UNCLEAVED
LRVFCQA_0.pdb	UNCLEAVED
TRCGGQA_2.pdb	UNCLEAVED
EFHGCQA_0.pdb	UNCLEAVED
MDFDIQA_1.pdb	UNCLEAVED
TFFGFQA_0.pdb	UNCLEAVED
LDAYGQA_0.pdb	UNCLEAVED
LDHGFQA_2.pdb	UNCLEAVED
HLSSMQA_2.pdb	UNCLEAVED
YRPSFQA_4.pdb	UNCLEAVED
SGTNFQA_4.pdb	UNCLEAVED
LGVGNQA_3.pdb	UNCLEAVED
VHHRDQA_2.pdb	UNCLEAVED
VSIFIQA_4.pdb	UNCLEAVED
CENRTQA_4.pdb	UNCLEAVED
GLDWRQA_4.pdb	UNCLEAVED
RHYQSQA_2.pdb	UNCLEAVED
FYTWVQA_3.pdb	UNCLEAVED
STISDQA_4.pdb	UNCLEAVED
CLSDSQA_4.pdb	UNCLEAVED
PFSSSQA_0.pdb	UNCLEAVED
YGRARQA_3.pdb	UNCLEAVED
LNSFYQA_3.pdb	UNCLEAVED
VWYLFQA_3.pdb	UNCLEAVED
VSGRVQA_1.pdb	UNCLEAVED
GMYCFQA_2.pdb	UNCLEAVED
CVVPAQA_0.pdb	UNCLEAVED
LLCLIQA_2.pdb	UNCLEAVED
CLLCTQA_1.pdb	UNCLEAVED
DTGVNQA_4.pdb	UNCLEAVED
CWRFHQA_3.pdb	UNCLEAVED
SWRFCQA_3.pdb	UNCLEAVED
RLRSAQA_2.pdb	UNCLEAVED
SSMSHQA_2.pdb	UNCLEAVED
SLPMTQA_2.pdb	UNCLEAVED
NDSRPQA_3.pdb	UNCLEAVED
VFTSRQA_4.pdb	UNCLEAVED
RNASTQA_1.pdb	UNCLEAVED
YMELYQA_1.pdb	UNCLEAVED
ITMFVQA_0.pdb	UNCLEAVED
ISRKLQA_3.pdb	UNCLEAVED
ESHNSQA_2.pdb	UNCLEAVED
NSYVLQA_0.pdb	UNCLEAVED
VTFEFQA_3.pdb	UNCLEAVED
CRIRSQA_4.pdb	UNCLEAVED
FIRMSQA_2.pdb	UNCLEAVED
TQEYAQA_3.pdb	UNCLEAVED
SVMCRQA_3.pdb	UNCLEAVED
RLSVYQA_0.pdb	UNCLEAVED
HHWSWQA_2.pdb	UNCLEAVED
PALVDQA_1.pdb	UNCLEAVED
RCNEGQA_4.pdb	UNCLEAVED
PHVSSQA_2.pdb	UNCLEAVED
YLRCSQA_0.pdb	UNCLEAVED
SRLLRQA_1.pdb	UNCLEAVED
GYLDMQA_1.pdb	UNCLEAVED
LSNVLQA_1.pdb	UNCLEAVED
MAKDTQA_2.pdb	UNCLEAVED
GYYGVQA_1.pdb	UNCLEAVED
SISHCQA_3.pdb	UNCLEAVED
DCFACQA_2.pdb	UNCLEAVED
HRHTRQA_3.pdb	UNCLEAVED
CGLVMQA_0.pdb	UNCLEAVED
NFPSCQA_0.pdb	UNCLEAVED
GLVHAQA_0.pdb	UNCLEAVED
RTLKEQA_2.pdb	UNCLEAVED
LVRASQA_3.pdb	UNCLEAVED
FTWMLQA_1.pdb	UNCLEAVED
GRVSEQA_3.pdb	UNCLEAVED
TFSLRQA_2.pdb	UNCLEAVED
CSTWVQA_3.pdb	UNCLEAVED
IRSTLQA_2.pdb	UNCLEAVED
CSFFLQA_1.pdb	UNCLEAVED
VNNETQA_2.pdb	UNCLEAVED
DRGRWQA_4.pdb	UNCLEAVED
VRKLGQA_1.pdb	UNCLEAVED
WHCSMQA_3.pdb	UNCLEAVED
LYKCQQA_0.pdb	UNCLEAVED
MKLGGQA_1.pdb	UNCLEAVED
GWYVKQA_1.pdb	UNCLEAVED
FYTKCQA_1.pdb	UNCLEAVED
IDRSMQA_2.pdb	UNCLEAVED
RANDYQA_0.pdb	UNCLEAVED
WWVSYQA_3.pdb	UNCLEAVED
NACLTQA_2.pdb	UNCLEAVED
RAILLQA_0.pdb	UNCLEAVED
YWFMCQA_1.pdb	UNCLEAVED
CRRLWQA_3.pdb	UNCLEAVED
CGVGTQA_3.pdb	UNCLEAVED
PCGYRQA_4.pdb	UNCLEAVED
FCRSRQA_1.pdb	UNCLEAVED
SPMNFQA_1.pdb	UNCLEAVED
MSHAPQA_2.pdb	UNCLEAVED
YGQQRQA_1.pdb	UNCLEAVED
GGAVCQA_2.pdb	UNCLEAVED
IRSAFQA_2.pdb	UNCLEAVED
VFCLRQA_2.pdb	UNCLEAVED
LCVWGQA_2.pdb	UNCLEAVED
FHTSLQA_3.pdb	UNCLEAVED
NPSKKQA_4.pdb	UNCLEAVED
TAGRYQA_1.pdb	UNCLEAVED
TLHEFQA_1.pdb	UNCLEAVED
GLGSSQA_4.pdb	UNCLEAVED
CPCVVQA_4.pdb	UNCLEAVED
SGWSPQA_4.pdb	UNCLEAVED
YSLLWQA_4.pdb	UNCLEAVED
MVSQGQA_2.pdb	UNCLEAVED
RWDEWQA_0.pdb	UNCLEAVED
LNTMDQA_4.pdb	UNCLEAVED
LLTFTQA_1.pdb	UNCLEAVED
QALYVQA_1.pdb	UNCLEAVED
YSRTVQA_2.pdb	UNCLEAVED
GIRVCQA_0.pdb	UNCLEAVED
MDEVTQA_0.pdb	UNCLEAVED
HEVGEQA_0.pdb	UNCLEAVED
PDDVMQA_3.pdb	UNCLEAVED
RFEQWQA_2.pdb	UNCLEAVED
QFIRDQA_3.pdb	UNCLEAVED
IGYSSQA_3.pdb	UNCLEAVED
CVSRVQA_0.pdb	UNCLEAVED
MMCLMQA_4.pdb	UNCLEAVED
VCIFCQA_0.pdb	UNCLEAVED
LAYGWQA_4.pdb	UNCLEAVED
FVAYGQA_0.pdb	UNCLEAVED
TGVLEQA_4.pdb	UNCLEAVED
LRYILQA_3.pdb	UNCLEAVED
CCVHPQA_2.pdb	UNCLEAVED
NAFVRQA_3.pdb	UNCLEAVED
SQWPGQA_4.pdb	UNCLEAVED
GNVSTQA_1.pdb	UNCLEAVED
VYYCSQA_4.pdb	UNCLEAVED
AHVRQQA_4.pdb	UNCLEAVED
ADEVMQA_3.pdb	UNCLEAVED
RLAAAQA_2.pdb	UNCLEAVED
RILRHQA_1.pdb	UNCLEAVED
FINRYQA_4.pdb	UNCLEAVED
SCNSYQA_0.pdb	UNCLEAVED
RNLSCQA_3.pdb	UNCLEAVED
SIFIVQA_4.pdb	UNCLEAVED
AVYNSQA_3.pdb	UNCLEAVED
NRLQRQA_3.pdb	UNCLEAVED
LDSCNQA_2.pdb	UNCLEAVED
TCTRWQA_2.pdb	UNCLEAVED
FVVTDQA_0.pdb	UNCLEAVED
CFRHSQA_3.pdb	UNCLEAVED
WSCTVQA_1.pdb	UNCLEAVED
LWYGVQA_0.pdb	UNCLEAVED
PINCMQA_1.pdb	UNCLEAVED
CRFGWQA_3.pdb	UNCLEAVED
VVVSQQA_4.pdb	UNCLEAVED
SQRDRQA_2.pdb	UNCLEAVED
TYKVCQA_4.pdb	UNCLEAVED
RNSVRQA_4.pdb	UNCLEAVED
EVPMFQA_3.pdb	UNCLEAVED
TRGASQA_3.pdb	UNCLEAVED
CYCVGQA_3.pdb	UNCLEAVED
CSWWTQA_3.pdb	UNCLEAVED
RQYVKQA_0.pdb	UNCLEAVED
WRYVIQA_4.pdb	UNCLEAVED
LSLGTQA_1.pdb	UNCLEAVED
LFSHNQA_3.pdb	UNCLEAVED
GDMCEQA_1.pdb	UNCLEAVED
NRKSGQA_0.pdb	UNCLEAVED
WSSLGQA_1.pdb	UNCLEAVED
KMNLNQA_4.pdb	UNCLEAVED
YHFKVQA_2.pdb	UNCLEAVED
FLSISQA_1.pdb	UNCLEAVED
LDCDSQA_0.pdb	UNCLEAVED
HRVYDQA_3.pdb	UNCLEAVED
FGGFNQA_4.pdb	UNCLEAVED
CRFWGQA_1.pdb	UNCLEAVED
CVGYWQA_3.pdb	UNCLEAVED
YMIILQA_4.pdb	UNCLEAVED
ECHFTQA_3.pdb	UNCLEAVED
KHRSNQA_4.pdb	UNCLEAVED
RANVDQA_1.pdb	UNCLEAVED
IDALGQA_0.pdb	UNCLEAVED
LGWALQA_0.pdb	UNCLEAVED
STWRMQA_1.pdb	UNCLEAVED
SPTIRQA_4.pdb	UNCLEAVED
QSRVRQA_0.pdb	UNCLEAVED
SRDRTQA_0.pdb	UNCLEAVED
RGTVTQA_4.pdb	UNCLEAVED
LESKMQA_4.pdb	UNCLEAVED
ALVSPQA_2.pdb	UNCLEAVED
EILKFQA_0.pdb	UNCLEAVED
SVYAHQA_3.pdb	UNCLEAVED
VAHLWQA_2.pdb	UNCLEAVED
GCVWAQA_3.pdb	UNCLEAVED
TFWCFQA_1.pdb	UNCLEAVED
RDVYIQA_1.pdb	UNCLEAVED
TCRSHQA_3.pdb	UNCLEAVED
DDTAKQA_2.pdb	UNCLEAVED
CCTYLQA_4.pdb	UNCLEAVED
RKDDEQA_2.pdb	UNCLEAVED
IVPIPQA_4.pdb	UNCLEAVED
RHEISQA_3.pdb	UNCLEAVED
GWSFGQA_0.pdb	UNCLEAVED
WWCNLQA_1.pdb	UNCLEAVED
AMSVHQA_3.pdb	UNCLEAVED
CPSIGQA_4.pdb	UNCLEAVED
DCAVCQA_3.pdb	UNCLEAVED
DFKKVQA_2.pdb	UNCLEAVED
RLCMGQA_2.pdb	UNCLEAVED
RLDLTQA_1.pdb	UNCLEAVED
GDVWSQA_4.pdb	UNCLEAVED
RGNINQA_2.pdb	UNCLEAVED
RMAQLQA_3.pdb	UNCLEAVED
LDLNPQA_1.pdb	UNCLEAVED
AGTRRQA_3.pdb	UNCLEAVED
GVSGCQA_2.pdb	UNCLEAVED
TGGAVQA_4.pdb	UNCLEAVED
SSNCQQA_4.pdb	UNCLEAVED
SHLSEQA_2.pdb	UNCLEAVED
WRAQNQA_1.pdb	UNCLEAVED
HCAFIQA_4.pdb	UNCLEAVED
EGFQAQA_2.pdb	UNCLEAVED
HVPHRQA_4.pdb	UNCLEAVED
WFLSLQA_0.pdb	UNCLEAVED
RLMCLQA_3.pdb	UNCLEAVED
TDSVTQA_1.pdb	UNCLEAVED
IQAFRQA_0.pdb	UNCLEAVED
RFRHSQA_2.pdb	UNCLEAVED
KVMPAQA_4.pdb	UNCLEAVED
YAFKPQA_3.pdb	UNCLEAVED
AGGDFQA_2.pdb	UNCLEAVED
MYRWTQA_4.pdb	UNCLEAVED
WHYTCQA_1.pdb	UNCLEAVED
DTSYWQA_2.pdb	UNCLEAVED
GEPDCQA_1.pdb	UNCLEAVED
GDRRGQA_3.pdb	UNCLEAVED
VVMECQA_0.pdb	UNCLEAVED
DWHSGQA_3.pdb	UNCLEAVED
EDSSTQA_4.pdb	UNCLEAVED
RESFYQA_2.pdb	UNCLEAVED
WRTGWQA_1.pdb	UNCLEAVED
FLSLVQA_3.pdb	UNCLEAVED
STGIYQA_1.pdb	UNCLEAVED
SQSKHQA_3.pdb	UNCLEAVED
LLFSFQA_4.pdb	UNCLEAVED
STHKWQA_1.pdb	UNCLEAVED
VLYGDQA_0.pdb	UNCLEAVED
AHQVRQA_4.pdb	UNCLEAVED
VWEVRQA_1.pdb	UNCLEAVED
SKQRHQA_0.pdb	UNCLEAVED
GTPSEQA_0.pdb	UNCLEAVED
SHILDQA_3.pdb	UNCLEAVED
DRRVGQA_2.pdb	UNCLEAVED
FNSTVQA_3.pdb	UNCLEAVED
EALWSQA_3.pdb	UNCLEAVED
QLWYPQA_2.pdb	UNCLEAVED
WSLCTQA_0.pdb	UNCLEAVED
YGGLHQA_0.pdb	UNCLEAVED
EITFGQA_0.pdb	UNCLEAVED
WFDGCQA_2.pdb	UNCLEAVED
TLRLVQA_2.pdb	UNCLEAVED
SGWTTQA_3.pdb	UNCLEAVED
IYTLKQA_1.pdb	UNCLEAVED
YTFFSQA_2.pdb	UNCLEAVED
IENMLQA_4.pdb	UNCLEAVED
QSGSRQA_1.pdb	UNCLEAVED
GVSSRQA_3.pdb	UNCLEAVED
FYLDGQA_4.pdb	UNCLEAVED
EYFAWQA_2.pdb	UNCLEAVED
LATPMQA_2.pdb	UNCLEAVED
PLKCFQA_1.pdb	UNCLEAVED
MDLLYQA_2.pdb	UNCLEAVED
FAWLFQA_3.pdb	UNCLEAVED
TCIGSQA_3.pdb	UNCLEAVED
LRAVSQA_2.pdb	UNCLEAVED
RGLYGQA_0.pdb	UNCLEAVED
NVVDVQA_3.pdb	UNCLEAVED
EYLFAQA_4.pdb	UNCLEAVED
DTTSEQA_2.pdb	UNCLEAVED
WGPHNQA_1.pdb	UNCLEAVED
RRWTAQA_2.pdb	UNCLEAVED
SLRLIQA_2.pdb	UNCLEAVED
RCGAVQA_0.pdb	UNCLEAVED
FMVDIQA_3.pdb	UNCLEAVED
RIVLSQA_2.pdb	UNCLEAVED
SDAGKQA_2.pdb	UNCLEAVED
RISWKQA_2.pdb	UNCLEAVED
WGMRGQA_1.pdb	UNCLEAVED
TWDMQQA_1.pdb	UNCLEAVED
SVYILQA_3.pdb	UNCLEAVED
FSLTEQA_0.pdb	UNCLEAVED
VSRVCQA_0.pdb	UNCLEAVED
FVGEFQA_2.pdb	UNCLEAVED
WLVNCQA_4.pdb	UNCLEAVED
HCDILQA_1.pdb	UNCLEAVED
SLFFSQA_3.pdb	UNCLEAVED
FMDFAQA_2.pdb	UNCLEAVED
KHNVGQA_4.pdb	UNCLEAVED
EVAVHQA_4.pdb	UNCLEAVED
TKRIKQA_1.pdb	UNCLEAVED
SSKLEQA_3.pdb	UNCLEAVED
RFRSGQA_3.pdb	UNCLEAVED
STRKMQA_0.pdb	UNCLEAVED
ISAWTQA_4.pdb	UNCLEAVED
PYECYQA_4.pdb	UNCLEAVED
ASPNVQA_4.pdb	UNCLEAVED
WLFRQQA_4.pdb	UNCLEAVED
QCYAHQA_3.pdb	UNCLEAVED
QECTQQA_0.pdb	UNCLEAVED
LHRLVQA_2.pdb	UNCLEAVED
LIPADQA_3.pdb	UNCLEAVED
KSRLSQA_4.pdb	UNCLEAVED
LHRWVQA_1.pdb	UNCLEAVED
NSSLGQA_2.pdb	UNCLEAVED
GFSMLQA_2.pdb	UNCLEAVED
KQLRLQA_3.pdb	UNCLEAVED
TPMAYQA_1.pdb	UNCLEAVED
EGAVKQA_2.pdb	UNCLEAVED
PLYSWQA_2.pdb	UNCLEAVED
EWTVSQA_1.pdb	UNCLEAVED
HFGTFQA_2.pdb	UNCLEAVED
RCIWGQA_0.pdb	UNCLEAVED
HPVFRQA_4.pdb	UNCLEAVED
HFPCKQA_2.pdb	UNCLEAVED
DLVVIQA_2.pdb	UNCLEAVED
LSWIFQA_2.pdb	UNCLEAVED
CSDVLQA_3.pdb	UNCLEAVED
CDFRPQA_3.pdb	UNCLEAVED
TFACSQA_4.pdb	UNCLEAVED
LCSARQA_1.pdb	UNCLEAVED
YAGMDQA_2.pdb	UNCLEAVED
TCDLLQA_1.pdb	UNCLEAVED
NQFMLQA_3.pdb	UNCLEAVED
YNGCSQA_4.pdb	UNCLEAVED
FCTTIQA_2.pdb	UNCLEAVED
STIIQQA_3.pdb	UNCLEAVED
ERRKEQA_2.pdb	UNCLEAVED
RVDMVQA_4.pdb	UNCLEAVED
CYENDQA_0.pdb	UNCLEAVED
RMFCMQA_2.pdb	UNCLEAVED
THDYSQA_4.pdb	UNCLEAVED
LEATDQA_4.pdb	UNCLEAVED
FGDWAQA_2.pdb	UNCLEAVED
IAGCYQA_1.pdb	UNCLEAVED
QSMPMQA_0.pdb	UNCLEAVED
YSGRVQA_2.pdb	UNCLEAVED
WAWKAQA_0.pdb	UNCLEAVED
LWPVMQA_3.pdb	UNCLEAVED
CPTGNQA_1.pdb	UNCLEAVED
CVSCIQA_2.pdb	UNCLEAVED
GCTSRQA_1.pdb	UNCLEAVED
TTRCEQA_4.pdb	UNCLEAVED
SCLQMQA_1.pdb	UNCLEAVED
ITLCVQA_1.pdb	UNCLEAVED
WSLPNQA_2.pdb	UNCLEAVED
CWIILQA_0.pdb	UNCLEAVED
ILLRSQA_2.pdb	UNCLEAVED
GDRSMQA_0.pdb	UNCLEAVED
CDVGMQA_0.pdb	UNCLEAVED
CSEVMQA_4.pdb	UNCLEAVED
QYLGAQA_2.pdb	UNCLEAVED
ELRTLQA_0.pdb	UNCLEAVED
YQLSPQA_2.pdb	UNCLEAVED
DVPSHQA_3.pdb	UNCLEAVED
YVKSHQA_3.pdb	UNCLEAVED
RYCNTQA_3.pdb	UNCLEAVED
DALLRQA_1.pdb	UNCLEAVED
SLSSTQA_3.pdb	UNCLEAVED
RRPGTQA_1.pdb	UNCLEAVED
GCMGSQA_1.pdb	UNCLEAVED
HTLKGQA_2.pdb	UNCLEAVED
VNLELQA_4.pdb	UNCLEAVED
ISWVLQA_3.pdb	UNCLEAVED
LLHSFQA_3.pdb	UNCLEAVED
VNGHPQA_4.pdb	UNCLEAVED
QDSAAQA_2.pdb	UNCLEAVED
NRYYGQA_1.pdb	UNCLEAVED
ITCWLQA_4.pdb	UNCLEAVED
MYKPCQA_2.pdb	UNCLEAVED
FDRTTQA_3.pdb	UNCLEAVED
MLGSAQA_1.pdb	UNCLEAVED
MDGNTQA_4.pdb	UNCLEAVED
LDKMLQA_2.pdb	UNCLEAVED
SPTMFQA_0.pdb	UNCLEAVED
FDVPFQA_3.pdb	UNCLEAVED
LQERVQA_3.pdb	UNCLEAVED
SAALAQA_2.pdb	UNCLEAVED
IFDHMQA_1.pdb	UNCLEAVED
HHGGYQA_2.pdb	UNCLEAVED
LVSCMQA_0.pdb	UNCLEAVED
RFHEAQA_2.pdb	UNCLEAVED
PGRRKQA_2.pdb	UNCLEAVED
NYCLGQA_3.pdb	UNCLEAVED
KFNGSQA_3.pdb	UNCLEAVED
IHGLLQA_4.pdb	UNCLEAVED
FSLQPQA_3.pdb	UNCLEAVED
NGGFSQA_0.pdb	UNCLEAVED
TMLNPQA_0.pdb	UNCLEAVED
HFNGMQA_2.pdb	UNCLEAVED
FEQLLQA_2.pdb	UNCLEAVED
LCYLSQA_3.pdb	UNCLEAVED
LFAVGQA_2.pdb	UNCLEAVED
MGMPCQA_2.pdb	UNCLEAVED
RRSAGQA_3.pdb	UNCLEAVED
TYWHVQA_0.pdb	UNCLEAVED
TYLDWQA_4.pdb	UNCLEAVED
YMYVEQA_2.pdb	UNCLEAVED
GLVFAQA_4.pdb	UNCLEAVED
VARSAQA_3.pdb	UNCLEAVED
IYYLYQA_4.pdb	UNCLEAVED
LRVLSQA_4.pdb	UNCLEAVED
GSRRKQA_4.pdb	UNCLEAVED
RAVTGQA_0.pdb	UNCLEAVED
VCRCDQA_1.pdb	UNCLEAVED
FLRWGQA_4.pdb	UNCLEAVED
ICVCGQA_4.pdb	UNCLEAVED
ISSMQQA_2.pdb	UNCLEAVED
EKPLGQA_1.pdb	UNCLEAVED
SRCGTQA_3.pdb	UNCLEAVED
SLSADQA_3.pdb	UNCLEAVED
WCMSRQA_2.pdb	UNCLEAVED
IDDLFQA_2.pdb	UNCLEAVED
FRSLAQA_0.pdb	UNCLEAVED
CSLTAQA_0.pdb	UNCLEAVED
VRVSNQA_2.pdb	UNCLEAVED
AERVGQA_3.pdb	UNCLEAVED
PMVDHQA_0.pdb	UNCLEAVED
GIFRHQA_2.pdb	UNCLEAVED
ILHRNQA_4.pdb	UNCLEAVED
CTSYFQA_4.pdb	UNCLEAVED
RNVEIQA_4.pdb	UNCLEAVED
VVIPMQA_3.pdb	UNCLEAVED
FRSGAQA_1.pdb	UNCLEAVED
RQISKQA_1.pdb	UNCLEAVED
NLLSVQA_0.pdb	UNCLEAVED
RLCSTQA_1.pdb	UNCLEAVED
LRELVQA_2.pdb	UNCLEAVED
SWRVFQA_4.pdb	UNCLEAVED
HVQANQA_4.pdb	UNCLEAVED
PRDHRQA_3.pdb	UNCLEAVED
MYMLVQA_2.pdb	UNCLEAVED
RTRSGQA_0.pdb	UNCLEAVED
VLSRGQA_0.pdb	UNCLEAVED
LFCRSQA_2.pdb	UNCLEAVED
IFFPNQA_0.pdb	UNCLEAVED
THSSIQA_4.pdb	UNCLEAVED
VLPNSQA_1.pdb	UNCLEAVED
LLALCQA_4.pdb	UNCLEAVED
SSLCAQA_1.pdb	UNCLEAVED
CNLLHQA_4.pdb	UNCLEAVED
RGTRCQA_0.pdb	UNCLEAVED
VHGYGQA_2.pdb	UNCLEAVED
HRTHSQA_3.pdb	UNCLEAVED
ADYRAQA_0.pdb	UNCLEAVED
AGRLCQA_2.pdb	UNCLEAVED
LEFWCQA_1.pdb	UNCLEAVED
DETLKQA_0.pdb	UNCLEAVED
WFTWDQA_4.pdb	UNCLEAVED
CLHWRQA_1.pdb	UNCLEAVED
RVCRCQA_3.pdb	UNCLEAVED
SRSRGQA_3.pdb	UNCLEAVED
CNVSAQA_4.pdb	UNCLEAVED
DRDLLQA_3.pdb	UNCLEAVED
KRLGCQA_0.pdb	UNCLEAVED
EVYCHQA_3.pdb	UNCLEAVED
AAMHNQA_0.pdb	UNCLEAVED
SGTVSQA_3.pdb	UNCLEAVED
WGHRCQA_0.pdb	UNCLEAVED
VRWWNQA_4.pdb	UNCLEAVED
RRWFQQA_2.pdb	UNCLEAVED
VSGHHQA_4.pdb	UNCLEAVED
HGNRSQA_2.pdb	UNCLEAVED
NSPTIQA_2.pdb	UNCLEAVED
RYRVVQA_4.pdb	UNCLEAVED
FRTLCQA_1.pdb	UNCLEAVED
EVRVTQA_4.pdb	UNCLEAVED
ILNRTQA_2.pdb	UNCLEAVED
VNVDGQA_4.pdb	UNCLEAVED
TNYGRQA_3.pdb	UNCLEAVED
YQAVHQA_2.pdb	UNCLEAVED
GDSRVQA_0.pdb	UNCLEAVED
SKKLIQA_4.pdb	UNCLEAVED
LRRTEQA_3.pdb	UNCLEAVED
MYLGMQA_2.pdb	UNCLEAVED
EWALGQA_0.pdb	UNCLEAVED
RWEWTQA_3.pdb	UNCLEAVED
RGMVLQA_2.pdb	UNCLEAVED
EWSVGQA_4.pdb	UNCLEAVED
KRYGFQA_0.pdb	UNCLEAVED
WLWLMQA_0.pdb	UNCLEAVED
KCLYCQA_1.pdb	UNCLEAVED
SAKRGQA_3.pdb	UNCLEAVED
RVFLIQA_0.pdb	UNCLEAVED
LGRLRQA_0.pdb	UNCLEAVED
YDGVGQA_0.pdb	UNCLEAVED
GISRMQA_4.pdb	UNCLEAVED
VSRFLQA_2.pdb	UNCLEAVED
THSRDQA_0.pdb	UNCLEAVED
NQISCQA_2.pdb	UNCLEAVED
NYRWHQA_0.pdb	UNCLEAVED
CGRRNQA_0.pdb	UNCLEAVED
DCQPRQA_1.pdb	UNCLEAVED
WCFMRQA_4.pdb	UNCLEAVED
LPGHCQA_1.pdb	UNCLEAVED
SSTTCQA_1.pdb	UNCLEAVED
SRWERQA_3.pdb	UNCLEAVED
LTDYTQA_1.pdb	UNCLEAVED
RHATGQA_0.pdb	UNCLEAVED
FSRNTQA_2.pdb	UNCLEAVED
LGKFHQA_4.pdb	UNCLEAVED
RLSHNQA_3.pdb	UNCLEAVED
CQMEFQA_3.pdb	UNCLEAVED
QAPDEQA_3.pdb	UNCLEAVED
KPELCQA_1.pdb	UNCLEAVED
PSQGKQA_1.pdb	UNCLEAVED
RTKPVQA_0.pdb	UNCLEAVED
VFLDDQA_4.pdb	UNCLEAVED
LYSSQQA_1.pdb	UNCLEAVED
GMRCRQA_0.pdb	UNCLEAVED
SLMKTQA_4.pdb	UNCLEAVED
WHAKSQA_4.pdb	UNCLEAVED
LLLYHQA_1.pdb	UNCLEAVED
CHKKDQA_1.pdb	UNCLEAVED
RLFASQA_4.pdb	UNCLEAVED
DLQSLQA_0.pdb	UNCLEAVED
GCRWHQA_1.pdb	UNCLEAVED
LHNKGQA_2.pdb	UNCLEAVED
IVWDVQA_2.pdb	UNCLEAVED
MPMYQQA_2.pdb	UNCLEAVED
VSKLYQA_4.pdb	UNCLEAVED
SNRNVQA_1.pdb	UNCLEAVED
DNLTCQA_0.pdb	UNCLEAVED
HFHLSQA_4.pdb	UNCLEAVED
SSMSAQA_0.pdb	UNCLEAVED
DHLGEQA_2.pdb	UNCLEAVED
RYIVDQA_1.pdb	UNCLEAVED
TPARSQA_3.pdb	UNCLEAVED
PTPSHQS_0.pdb	UNCLEAVED
FRPTHQS_4.pdb	UNCLEAVED
TSCMCQA_1.pdb	UNCLEAVED
YSRGKQA_0.pdb	UNCLEAVED
SGGYCQA_0.pdb	UNCLEAVED
LSVSIQA_3.pdb	UNCLEAVED
NANGSQA_2.pdb	UNCLEAVED
DRNSCQA_3.pdb	UNCLEAVED
NALGDQA_3.pdb	UNCLEAVED
NHPVRQA_3.pdb	UNCLEAVED
ISLWRQA_0.pdb	UNCLEAVED
CCLHCQA_3.pdb	UNCLEAVED
VIVAIQA_4.pdb	UNCLEAVED
SCSMYQA_0.pdb	UNCLEAVED
LCACWQA_4.pdb	UNCLEAVED
QCHDAQA_2.pdb	UNCLEAVED
HAARSQA_0.pdb	UNCLEAVED
VGDDSQA_0.pdb	UNCLEAVED
SHTMDQA_1.pdb	UNCLEAVED
CYFWIQA_0.pdb	UNCLEAVED
YECAGQA_0.pdb	UNCLEAVED
WRIHRQA_4.pdb	UNCLEAVED
LAWSFQA_0.pdb	UNCLEAVED
QLASNQA_3.pdb	UNCLEAVED
HGFRGQA_1.pdb	UNCLEAVED
HAVLSQA_2.pdb	UNCLEAVED
CKRCMQA_2.pdb	UNCLEAVED
RRNCVQA_4.pdb	UNCLEAVED
NSSFTQA_0.pdb	UNCLEAVED
SFGWWQA_4.pdb	UNCLEAVED
NWLEFQA_4.pdb	UNCLEAVED
CVYAEQA_0.pdb	UNCLEAVED
PRECGQA_0.pdb	UNCLEAVED
DSWFGQA_1.pdb	UNCLEAVED
WLTSIQA_2.pdb	UNCLEAVED
CPVMVQA_0.pdb	UNCLEAVED
SVTQKQA_0.pdb	UNCLEAVED
ITLVMQA_1.pdb	UNCLEAVED
LENFYQA_1.pdb	UNCLEAVED
CLLGAQA_1.pdb	UNCLEAVED
WRGHRQA_0.pdb	UNCLEAVED
KMYLHQA_4.pdb	UNCLEAVED
YWVWLQA_2.pdb	UNCLEAVED
FSFVRQA_0.pdb	UNCLEAVED
GVSVRQA_1.pdb	UNCLEAVED
IVSQSQA_0.pdb	UNCLEAVED
TCTFSQA_3.pdb	UNCLEAVED
DSVLRQA_2.pdb	UNCLEAVED
SREQYQA_1.pdb	UNCLEAVED
LFIPYQA_3.pdb	UNCLEAVED
VRDLRQA_0.pdb	UNCLEAVED
GTGIVQA_2.pdb	UNCLEAVED
CCTVNQA_4.pdb	UNCLEAVED
PGLPNQA_1.pdb	UNCLEAVED
SFGRNQA_2.pdb	UNCLEAVED
LFTGSQA_0.pdb	UNCLEAVED
KSVTMQA_4.pdb	UNCLEAVED
DMSCFQA_1.pdb	UNCLEAVED
ATWMGQA_4.pdb	UNCLEAVED
TRRLIQA_3.pdb	UNCLEAVED
MGQRTQA_4.pdb	UNCLEAVED
CRNIQQA_0.pdb	UNCLEAVED
KCYVCQA_1.pdb	UNCLEAVED
IMVYSQA_0.pdb	UNCLEAVED
SLRMFQS_3.pdb	UNCLEAVED
LTKLMQA_1.pdb	UNCLEAVED
SPATVQS_1.pdb	UNCLEAVED
NGDGTQS_1.pdb	UNCLEAVED
DCLLHQA_2.pdb	UNCLEAVED
RSLLGQS_4.pdb	UNCLEAVED
IAVLHQS_4.pdb	UNCLEAVED
LWGWLQS_4.pdb	UNCLEAVED
LQKSCQS_0.pdb	UNCLEAVED
YSFCSQA_3.pdb	UNCLEAVED
AAADVQA_0.pdb	UNCLEAVED
RVLRLQA_4.pdb	UNCLEAVED
YFSGSQA_3.pdb	UNCLEAVED
TTLLWQA_2.pdb	UNCLEAVED
SKLDRQA_0.pdb	UNCLEAVED
LMRCHQA_3.pdb	UNCLEAVED
CVHSRQA_0.pdb	UNCLEAVED
PENINQA_1.pdb	UNCLEAVED
TKPLSQA_4.pdb	UNCLEAVED
ALFIAQA_3.pdb	UNCLEAVED
FTSRMQA_0.pdb	UNCLEAVED
PYTFHQA_2.pdb	UNCLEAVED
ALHSWQA_3.pdb	UNCLEAVED
ILYPWQA_4.pdb	UNCLEAVED
CVGAVQA_2.pdb	UNCLEAVED
LDLPVQA_1.pdb	UNCLEAVED
RCVQEQA_3.pdb	UNCLEAVED
WHCRRQA_4.pdb	UNCLEAVED
TGELIQA_0.pdb	UNCLEAVED
LTFEFQA_2.pdb	UNCLEAVED
RSCDLQA_4.pdb	UNCLEAVED
CVTFTQA_4.pdb	UNCLEAVED
GFIVMQA_4.pdb	UNCLEAVED
GVVLPQA_4.pdb	UNCLEAVED
YLSPYQA_0.pdb	UNCLEAVED
SVSSMQA_1.pdb	UNCLEAVED
VPWSRQA_0.pdb	UNCLEAVED
DVHSNQA_2.pdb	UNCLEAVED
VVGREQA_0.pdb	UNCLEAVED
NTPMLQA_1.pdb	UNCLEAVED
LGTCLQA_2.pdb	UNCLEAVED
WRVQPQA_3.pdb	UNCLEAVED
IYWNRQA_4.pdb	UNCLEAVED
ISEVDQA_3.pdb	UNCLEAVED
RLRVSQA_2.pdb	UNCLEAVED
SMAYHQA_1.pdb	UNCLEAVED
WEATTQA_4.pdb	UNCLEAVED
LNTDNQA_2.pdb	UNCLEAVED
VLDALQA_2.pdb	UNCLEAVED
KDKDGQA_0.pdb	UNCLEAVED
