Sequence	Result
LTQQCQA_0.pdb	CLEAVED
RFVVRQA_2.pdb	CLEAVED
LGLIYQA_3.pdb	CLEAVED
CVNPFQA_0.pdb	CLEAVED
CVVKRQA_2.pdb	CLEAVED
RVVKMQA_1.pdb	CLEAVED
INGCYQA_0.pdb	CLEAVED
HESVTQA_2.pdb	CLEAVED
LLALMQA_0.pdb	CLEAVED
WRISGQA_2.pdb	CLEAVED
GNQISQA_1.pdb	CLEAVED
DPRIIQA_3.pdb	CLEAVED
NHKSCQA_2.pdb	CLEAVED
QPFVKQA_0.pdb	CLEAVED
TCWGGQA_2.pdb	CLEAVED
KGQTRQA_2.pdb	CLEAVED
YMKNVQA_3.pdb	CLEAVED
GVMIGQA_2.pdb	CLEAVED
GKMYMQA_1.pdb	CLEAVED
WFAKVQA_1.pdb	CLEAVED
QLDVWQA_0.pdb	CLEAVED
RWKVGQA_1.pdb	CLEAVED
LILCLQA_1.pdb	CLEAVED
WTVNTQA_1.pdb	CLEAVED
AYGIEQA_1.pdb	CLEAVED
ELMYSQA_0.pdb	CLEAVED
IHYLLQA_2.pdb	CLEAVED
EDWYVQA_0.pdb	CLEAVED
DDEQSQA_1.pdb	CLEAVED
IRGVQQA_2.pdb	CLEAVED
TLLEGQA_2.pdb	CLEAVED
APCTGQA_2.pdb	CLEAVED
QSKHSQA_1.pdb	CLEAVED
FCFWMQA_2.pdb	CLEAVED
MYVDFQA_2.pdb	CLEAVED
KFSVAQA_2.pdb	CLEAVED
VNISHQA_4.pdb	CLEAVED
CYTGKQA_2.pdb	CLEAVED
GIGDVQA_3.pdb	CLEAVED
MTVIRQA_4.pdb	CLEAVED
GNLVMQA_4.pdb	CLEAVED
RFSTYQA_0.pdb	CLEAVED
LHILRQA_0.pdb	CLEAVED
MTWCTQA_2.pdb	CLEAVED
CLWCCQA_1.pdb	CLEAVED
MHTSSQA_3.pdb	CLEAVED
LQLRLQA_0.pdb	CLEAVED
LRIAVQA_4.pdb	CLEAVED
KRLTVQA_4.pdb	CLEAVED
IWVILQA_2.pdb	CLEAVED
MYVCGQA_4.pdb	CLEAVED
WSVVCQA_1.pdb	CLEAVED
MPMVLQA_4.pdb	CLEAVED
GPMARQA_0.pdb	CLEAVED
ESSRTQA_3.pdb	CLEAVED
WDRYTQA_2.pdb	CLEAVED
QGGSRQA_4.pdb	CLEAVED
LSTCLQA_4.pdb	CLEAVED
GDMVTQA_4.pdb	CLEAVED
MGCVSQA_0.pdb	CLEAVED
SVDTSQA_3.pdb	CLEAVED
RIRRRQA_0.pdb	CLEAVED
GERSMQA_4.pdb	CLEAVED
KIGTSQA_1.pdb	CLEAVED
TAMCAQA_3.pdb	CLEAVED
VDRWEQA_3.pdb	CLEAVED
KLRPRQA_2.pdb	CLEAVED
LNSVSQA_0.pdb	CLEAVED
HHFGRQA_2.pdb	CLEAVED
VRGSVQA_0.pdb	CLEAVED
PGGSRQA_1.pdb	CLEAVED
YTCLQQA_2.pdb	CLEAVED
LGDLPQA_1.pdb	CLEAVED
QCLGSQA_1.pdb	CLEAVED
NDGLNQA_0.pdb	CLEAVED
RDMSGQA_1.pdb	CLEAVED
WTSIVQA_3.pdb	CLEAVED
SRFLQQA_2.pdb	CLEAVED
ALWKSQA_4.pdb	CLEAVED
LSRRMQA_0.pdb	CLEAVED
LGGCSQA_2.pdb	CLEAVED
SVIPYQA_2.pdb	CLEAVED
NLVHCQA_4.pdb	CLEAVED
AERRQQA_1.pdb	CLEAVED
CAYVIQA_2.pdb	CLEAVED
KRAPLQA_0.pdb	CLEAVED
LSPVSQA_3.pdb	CLEAVED
TPRGTQA_2.pdb	CLEAVED
SENCTQA_0.pdb	CLEAVED
YLLIFQA_3.pdb	CLEAVED
QVGSMQA_3.pdb	CLEAVED
ISLDYQA_0.pdb	CLEAVED
RPSFGQA_4.pdb	CLEAVED
CRWEGQA_3.pdb	CLEAVED
CLCRYQA_1.pdb	CLEAVED
RRWRRQA_1.pdb	CLEAVED
PRAVKQA_0.pdb	CLEAVED
RKLWTQA_0.pdb	CLEAVED
RVSRRQA_4.pdb	CLEAVED
CTNHVQA_1.pdb	CLEAVED
LWQFNQA_4.pdb	CLEAVED
SVNSWQA_0.pdb	CLEAVED
IFSFMQA_0.pdb	CLEAVED
HMRCLQA_1.pdb	CLEAVED
LSTKYQA_1.pdb	CLEAVED
LPDLIQA_0.pdb	CLEAVED
KLGPSQA_4.pdb	UNCLEAVED
SVMACQA_0.pdb	UNCLEAVED
TCTPKQA_4.pdb	UNCLEAVED
FCALTQA_0.pdb	UNCLEAVED
CHLRYQA_2.pdb	UNCLEAVED
SLLRGQA_4.pdb	UNCLEAVED
YMFMIQA_4.pdb	UNCLEAVED
IRTRVQA_2.pdb	UNCLEAVED
SHGQAQA_3.pdb	UNCLEAVED
TGILSQA_0.pdb	UNCLEAVED
SCNGRQA_4.pdb	UNCLEAVED
IVLLIQA_3.pdb	UNCLEAVED
EYCACQA_0.pdb	UNCLEAVED
WIEWCQA_2.pdb	UNCLEAVED
SSMFIQA_4.pdb	UNCLEAVED
ERLEWQA_2.pdb	UNCLEAVED
CERLCQA_1.pdb	UNCLEAVED
DLFSLQA_0.pdb	UNCLEAVED
LCCMLQA_0.pdb	UNCLEAVED
DRRQIQA_4.pdb	UNCLEAVED
SFISMQA_4.pdb	UNCLEAVED
GWGYHQA_0.pdb	UNCLEAVED
FLAVSQA_2.pdb	UNCLEAVED
PAWSFQA_0.pdb	UNCLEAVED
SMNFVQA_1.pdb	UNCLEAVED
KVWVFQA_3.pdb	UNCLEAVED
DLTIIQA_3.pdb	UNCLEAVED
ARHAVQA_4.pdb	UNCLEAVED
GVNSRQA_2.pdb	UNCLEAVED
QLPGKQA_1.pdb	UNCLEAVED
PAGWEQA_4.pdb	UNCLEAVED
WAFPSQA_2.pdb	UNCLEAVED
NCTESQA_4.pdb	UNCLEAVED
DLALTQA_3.pdb	UNCLEAVED
CSLHCQA_2.pdb	UNCLEAVED
YGTIIQA_4.pdb	UNCLEAVED
CMYSAQA_3.pdb	UNCLEAVED
SNAQGQA_2.pdb	UNCLEAVED
RSEVGQA_3.pdb	UNCLEAVED
YDRHGQA_2.pdb	UNCLEAVED
WVNGLQA_2.pdb	UNCLEAVED
NHSLGQA_1.pdb	UNCLEAVED
PYLAYQA_3.pdb	UNCLEAVED
LTVASQA_0.pdb	UNCLEAVED
LTKLMQA_4.pdb	UNCLEAVED
TRASNQA_1.pdb	UNCLEAVED
FAPMHQA_4.pdb	UNCLEAVED
VCSGVQA_0.pdb	UNCLEAVED
RELYPQA_2.pdb	UNCLEAVED
QSFHSQA_4.pdb	UNCLEAVED
LLVGIQA_0.pdb	UNCLEAVED
PANIEQA_2.pdb	UNCLEAVED
MTRENQA_2.pdb	UNCLEAVED
WLGCMQA_2.pdb	UNCLEAVED
SGEAYQA_4.pdb	UNCLEAVED
RYGCSQA_1.pdb	UNCLEAVED
FAISAQA_1.pdb	UNCLEAVED
HLRSAQA_3.pdb	UNCLEAVED
ACGLDQA_4.pdb	UNCLEAVED
RCGPEQA_0.pdb	UNCLEAVED
PSDAPQA_0.pdb	UNCLEAVED
SNWMHQA_0.pdb	UNCLEAVED
CYVVSQA_1.pdb	UNCLEAVED
IPGNDQA_1.pdb	UNCLEAVED
YWGRFQA_3.pdb	UNCLEAVED
RKPGGQA_1.pdb	UNCLEAVED
PSHMFQA_2.pdb	UNCLEAVED
CPSNYQA_0.pdb	UNCLEAVED
IRFVGQA_1.pdb	UNCLEAVED
NRLYSQA_2.pdb	UNCLEAVED
VSDLLQA_1.pdb	UNCLEAVED
NWSFRQA_2.pdb	UNCLEAVED
AASGRQA_0.pdb	UNCLEAVED
YESRRQA_0.pdb	UNCLEAVED
TGPIGQA_1.pdb	UNCLEAVED
RIQSIQA_1.pdb	UNCLEAVED
CVEKDQA_0.pdb	UNCLEAVED
FPAAGQA_2.pdb	UNCLEAVED
WMLSPQA_2.pdb	UNCLEAVED
SSCVSQA_3.pdb	UNCLEAVED
GSRMYQA_2.pdb	UNCLEAVED
MEASCQA_3.pdb	UNCLEAVED
MWMCGQA_1.pdb	UNCLEAVED
YSNRMQA_0.pdb	UNCLEAVED
PGRTRQA_2.pdb	UNCLEAVED
LPRGEQA_1.pdb	UNCLEAVED
PQGAYQA_4.pdb	UNCLEAVED
SLMPDQA_4.pdb	UNCLEAVED
ITSRPQA_4.pdb	UNCLEAVED
LRNTMQA_1.pdb	UNCLEAVED
LNFSVQA_3.pdb	UNCLEAVED
INGCFQA_3.pdb	UNCLEAVED
SLDSHQA_4.pdb	UNCLEAVED
RSTLGQA_0.pdb	UNCLEAVED
LIIQGQA_4.pdb	UNCLEAVED
TLVAAQA_4.pdb	UNCLEAVED
YLRMGQA_4.pdb	UNCLEAVED
GCMIHQA_1.pdb	UNCLEAVED
CGALVQA_2.pdb	UNCLEAVED
FGKGNQA_0.pdb	UNCLEAVED
RRPVCQA_1.pdb	UNCLEAVED
SGVGSQA_3.pdb	UNCLEAVED
MMFKGQA_3.pdb	UNCLEAVED
LVYLGQA_0.pdb	UNCLEAVED
GSCCVQA_1.pdb	UNCLEAVED
MYWNGQA_2.pdb	UNCLEAVED
VGLPNQA_2.pdb	UNCLEAVED
THCPFQA_1.pdb	UNCLEAVED
PSYHQQA_3.pdb	UNCLEAVED
SSRPRQA_4.pdb	UNCLEAVED
DAISRQA_0.pdb	UNCLEAVED
WLFYIQA_3.pdb	UNCLEAVED
LFRAWQA_1.pdb	UNCLEAVED
CGTVVQA_3.pdb	UNCLEAVED
YQTTGQA_4.pdb	UNCLEAVED
LCSTNQA_3.pdb	UNCLEAVED
RPVASQA_1.pdb	UNCLEAVED
PYITYQA_2.pdb	UNCLEAVED
THGHSQA_2.pdb	UNCLEAVED
RRYHDQA_3.pdb	UNCLEAVED
HFSLFQA_0.pdb	UNCLEAVED
HAQAHQA_2.pdb	UNCLEAVED
ILRAHQA_4.pdb	UNCLEAVED
RLMVFQA_4.pdb	UNCLEAVED
ASWPPQA_0.pdb	UNCLEAVED
SSGRSQA_4.pdb	UNCLEAVED
WRGSEQA_4.pdb	UNCLEAVED
FCVLYQA_2.pdb	UNCLEAVED
STLSYQA_1.pdb	UNCLEAVED
PPGGIQA_0.pdb	UNCLEAVED
HYSESQA_4.pdb	UNCLEAVED
SEGANQA_3.pdb	UNCLEAVED
ERGFFQA_2.pdb	UNCLEAVED
TRTVAQA_4.pdb	UNCLEAVED
GGVRWQA_1.pdb	UNCLEAVED
SYPVRQA_4.pdb	UNCLEAVED
EFSDVQA_1.pdb	UNCLEAVED
FYHTGQA_0.pdb	UNCLEAVED
MSVKSQA_0.pdb	UNCLEAVED
GECVSQA_4.pdb	UNCLEAVED
RSHRGQA_2.pdb	UNCLEAVED
RHYRSQA_3.pdb	UNCLEAVED
RLMLGQA_2.pdb	UNCLEAVED
FEGTSQA_3.pdb	UNCLEAVED
VWMGFQA_1.pdb	UNCLEAVED
SRRVSQA_0.pdb	UNCLEAVED
NEVEVQA_4.pdb	UNCLEAVED
TVSTSQA_2.pdb	UNCLEAVED
CQSYDQA_4.pdb	UNCLEAVED
LRNRTQA_3.pdb	UNCLEAVED
YTSGSQA_2.pdb	UNCLEAVED
KCTWCQA_2.pdb	UNCLEAVED
YWDPSQA_0.pdb	UNCLEAVED
ACNHPQA_0.pdb	UNCLEAVED
DYYNRQA_0.pdb	UNCLEAVED
SRFCIQA_2.pdb	UNCLEAVED
MMSDSQA_2.pdb	UNCLEAVED
GQLKWQA_0.pdb	UNCLEAVED
CSRWVQA_1.pdb	UNCLEAVED
STLYSQA_2.pdb	UNCLEAVED
LVLSVQA_3.pdb	UNCLEAVED
RGWLGQA_1.pdb	UNCLEAVED
HAYVLQA_4.pdb	UNCLEAVED
RSISSQA_4.pdb	UNCLEAVED
PRWKAQA_0.pdb	UNCLEAVED
SWHMIQA_3.pdb	UNCLEAVED
DRRFTQA_0.pdb	UNCLEAVED
LNGRGQA_0.pdb	UNCLEAVED
LAKQQQA_0.pdb	UNCLEAVED
YWLCRQA_4.pdb	UNCLEAVED
TNRAYQA_4.pdb	UNCLEAVED
SLRMIQA_1.pdb	UNCLEAVED
YFVCSQA_0.pdb	UNCLEAVED
DFFQVQA_2.pdb	UNCLEAVED
RKIQNQA_0.pdb	UNCLEAVED
TLFPCQA_4.pdb	UNCLEAVED
SWKMGQA_0.pdb	UNCLEAVED
TCNLRQA_2.pdb	UNCLEAVED
GDMPSQA_1.pdb	UNCLEAVED
RCAGMQA_1.pdb	UNCLEAVED
PRYCDQA_2.pdb	UNCLEAVED
VWTVHQA_2.pdb	UNCLEAVED
RLWLYQA_0.pdb	UNCLEAVED
LGSLWQA_4.pdb	UNCLEAVED
NWRCVQA_1.pdb	UNCLEAVED
WLLRTQA_4.pdb	UNCLEAVED
WPGSFQA_3.pdb	UNCLEAVED
HDSETQA_3.pdb	UNCLEAVED
LLVSCQA_0.pdb	UNCLEAVED
GRLVGQA_3.pdb	UNCLEAVED
TAVYFQA_2.pdb	UNCLEAVED
SGSHDQA_4.pdb	UNCLEAVED
TGFADQA_4.pdb	UNCLEAVED
RQANSQA_0.pdb	UNCLEAVED
NQRSAQA_0.pdb	UNCLEAVED
